а	
аба	noun
абадан	adj
абажа	noun
абажадай	adj
абажур	noun
абазин	noun
абай	adj
абайламай	adv
абайламаушылық	noun
абайлампаздық	noun
абайлап	adv
абайлаттыру	verb
абайлату	verb
абайлау	verb
абайлаушы	adj
абайлаушылық	noun
абайсыз	adj
абайсызда	adv
абайсыздық	noun
абайтану	noun
абайтанушы	noun
абайым	noun
абақ	noun
абақты	noun
абақы	adj
абалақ	adj
абалақ-сабалақ	noun
абалану	verb
абаласу	verb
абалаттыру	verb
абалату	verb
абалау	verb
абат	adj
абаттандыру	verb
абаттану	verb
абаттық	noun
абатшылық	noun
аббар	noun
аббат	noun
аббревиатура	noun
абдикация	noun
абдуктор	noun
абдукция	noun
абдыра	noun
абдыраған	adj
абдырасу	verb
абдырату	verb
абдырау	verb
абдыраушылық	noun
абдырауық	noun
аберрация	noun
аберрациялық	adj
абжад	noun
абжауқын	adj
абжылан	noun
абжыландай	adj
абзал	adj
абзалдық	noun
абзалы	adv
абзалында	
абзац	noun
абзел	noun
абиогендік	noun
абиссаль	noun
абиссин	noun
абиссиниялық	adj
абитуриент	noun
абиыр	noun
абиырсыз	adj
абиырсыздық	noun
аблаут	noun
аблығу	verb
аблықтыру	verb
абонемент	noun
абонементтелу	verb
абонементтеу	verb
абонементтік	adj
абонент	noun
абоненттік	adj
абордаж	noun
абордаждау	verb
абордажды	adj
абордаждық	adj
аборт	noun
абортивтік	adj
абразия	noun
абракадабра	noun
абрикотин	noun
абрис	noun
абсент	noun
абсентеизм	noun
абсолют	noun
абсолютизм	noun
абсолютті	adj
абсолюттік	adj
абсолюттілік	noun
абсолютшілдік	noun
абсорбент	noun
абсорбция	noun
абсорбциялау	verb
абстракт	adj
абстрактландыру	verb
абстрактлану	verb
абстрактлау	verb
абстракты	adj
абстракті	adj
абстрактілендіру	verb
абстрактілену	verb
абстрактілеу	verb
абстрактілі	adj
абстрактілік	adj
абстракционистік	adj
абстракция	noun
абстракциялану	verb
абстракциялау	verb
абстракциялаушы	noun
абстракциялы	adj
абстракциялық	adj
абстстракционизм	noun
абсцисса	noun
абұйыр	noun
абхаз	noun
абхаздық	adj
абыз	noun
абыздық	noun
абызсыну	verb
абыл-сабыл	adj
абылайша	adj
абылаңқы	noun
абылхаят	noun
абылыңқы-сабылыңқы	adj
абын	verb
абыну	verb
абынып-қабыну	verb
абың-күбің	noun
абың-қүбің	adj
абыр-гүбір	noun
абыр-дабыр	noun
абыр-жұбыр	noun
абыр-күбір	noun
абыр-сабыр	noun
абыржу	verb
абыржулы	adj
абыржушылық	noun
абыржыған	adj
абыржығыш	adj
абыржымастан	adv
абыржымау	adv
абыржып	adv
абыржысу	verb
абыржыту	verb
абырой	noun
абырой-атақ	noun
абырой-бедел	noun
абыройлы	adj
абыройлылық	noun
абыройсыз	adj
абыройсыздану	verb
абыройсыздық	noun
абысын	noun
абысын-ажын	adj
абысынды	adj
аваль	noun
авангард	noun
авангардизм	noun
авангардистік	adj
авангардтық	adj
авангардшы	noun
аванзал	noun
аванложа	noun
аванпорт	noun
аванпост	noun
аванс	noun
авансахна	noun
авансталған	adj
аванстау	verb
аванстық	adj
авансыланған	adj
авансылау	verb
авантюра	noun
авантюралық	adj
авантюризм	noun
авантюрист	noun
авантюристік	adj
авар	noun
авария	noun
авариясыз	adj
аверс	noun
авиаапат	noun
авиабағдаршам	noun
авиабаза	noun
авиабайланыс	noun
авиабилет	noun
авиабомба	noun
авиабөлім	noun
авиадесант	noun
авиажоба	noun
авиажол	noun
авиажөндеу	verb
авиазауыт	noun
авиаклуб	noun
авиакомпас	noun
авиаконструктор	noun
авиаконструкторлық	adj
авиакөкжиек	noun
авиакрейсер	noun
авиақойма	noun
авиақоректендіру	verb
авиақұрылыс	noun
авиақұрылысшы	noun
авиаматка	noun
авиамектеп	noun
авиамоделизм	noun
авиамодель	noun
авиамодельші	noun
авиамотор	noun
авианосец	noun
авиаотряд	noun
авиапарк	noun
авиаполк	noun
авиапорт	noun
авиапочта	noun
авиапошта	noun
авиапулемет	noun
авиаразведка	noun
авиасигнал	noun
авиаспорт	noun
авиаспорттық	adj
авиаспортшы	noun
авиатехник	noun
авиатозаңдандыру	verb
авиатор	noun
авиатрасса	noun
авиатүсірім	noun
авиация	noun
авиациялық	adj
авиаэскадрилья	noun
авиетка	noun
авизо	noun
ависта	noun
авитаминоз	noun
аврал	noun
австралиялық	noun
австриялық	noun
автаркия	noun
автоағаштасығыш	noun
автоара	noun
автоаспа	noun
автоаударғыш	noun
автоаудармашы	noun
автоаял	noun
автоәйнек	noun
автобаза	noun
автобазалық	adj
автобақылау	noun
автобақылаушы	noun
автобекет	noun
автоблокировка	noun
автобөлшек	noun
автобөлшектер	noun
автобус	noun
автовокзал	noun
автогараж	noun
автоген	noun
автогендік	noun
автогенші	noun
автографиялық	adj
автодабыл	noun
автодаңғыл	noun
автодәрілегіш	noun
автодиспетчер	noun
автодоғару	noun
автодоғарыс	noun
автодрезина	noun
автодром	noun
автодүкен	noun
автожарыс	noun
автожауап	noun
автожауапшы	noun
автожир	noun
автожол	noun
автожорық	noun
автожөндеу	noun
автожуғыш	noun
автожуу	noun
автожылжымалы	adj
автозауыт	noun
автокамера	noun
автокар	noun
автокеруен	noun
автоклав	noun
автокөлік	noun
автокөлікті	adj
автокөтергіш	noun
автократия	noun
автоқалам	noun
автоқатынас	noun
автоқозғалтқыш	noun
автоқозғалыс	noun
автоқосқыш	noun
автоқоспа	noun
автоқұрылыс	noun
автоқұрылысшы	noun
автол	noun
автолиз	noun
автолитография	noun
автомагистраль	noun
автомат	noun
автоматика	noun
автоматталған	adj
автоматталу	verb
автоматтандыру	verb
автоматтандырылған	adj
автоматтандырылу	verb
автоматтану	verb
автоматтау	verb
автоматты	adj
автоматтық	adj
автоматтылық	noun
автоматша	adv
автоматшы	noun
автомашина	noun
автомекен	noun
автомектеп	noun
автомеханик	noun
автомеханикалық	adj
автомобилизм	noun
автомобиль	noun
автомобильші	noun
автомоделизм	noun
автомодель	noun
автомодельші	noun
автомотодром	noun
автомотоклуб	noun
автомотоспорт	noun
автомотриса	noun
автомұнара	noun
автонауа	noun
автоним	noun
автономдық	adj
автономия	noun
автономиялы	adj
автономиялық	adj
автономияшыл	adj
автопарк	noun
автопилот	noun
автопойыз	noun
автопортрет	noun
автопісіргіш	noun
автопісіруші	noun
автор	noun
авторезеңке	noun
автореферат	noun
авторитаризм	noun
авторитарлық	adj
авторландыру	verb
авторлас	noun
авторластыру	verb
авторластырылған	adj
авторлық	noun
авторынок	noun
автосайыс	noun
автосауғыш	noun
автосборка	noun
автосервис	noun
автослесарь	noun
автосока	noun
автосоқа	noun
автосорғы	noun
автоспорт	noun
автостанция	noun
автосуарғыш	noun
автосуару	noun
автосуат	noun
автотаразы	noun
автотасымал	noun
автотежеуіш	noun
автотербеліс	noun
автотиегіш	noun
автотиеуіш	noun
автотипия	noun
автотрактор	noun
автотрансформатор	noun
автотрек	noun
автотуризм	noun
автотурист	noun
автотұрақ	noun
автотұрмыстық	adj
автотүсіргі	noun
автотүсіргіш	noun
автотізбек	noun
автотіркеме	noun
автотіркес	noun
автотіркеуіш	noun
автофертилдік	adj
автофургон	noun
автохат	noun
автохронометр	noun
автохронометраж	noun
автохтон	noun
автохтонды	adj
автохтондық	adj
автоцистерна	noun
автошабандоз	noun
автошана	noun
автошеберхана	noun
автошеру	noun
автошина	noun
автошығыр	noun
автоэпиграмма	noun
агава	noun
агат	adj
агглютинативті	adj
агглютинативтік	adj
агглютинация	noun
агент	noun
агенттік	noun
агентура	noun
агитатор	noun
агломерат	noun
агломератшы	noun
агломерация	noun
агломерациялық	adj
агностик	noun
агностикалық	adj
агностицизм	noun
агониялық	adj
аграрий	noun
аграрлы	adj
аграрлық	adj
аграрлық-өнеркәсіптік	adj
агрегат	noun
агрегаттық	adj
агреман	noun
агрессия	noun
агрессиялық	adj
агрессияшыл	adj
агрессияшылдық	noun
агрессор	noun
агрикультура	noun
агрикультуралық	adj
агробаза	noun
агробақылау	noun
агробиология	noun
агробиологиялық	adj
агробиологшы	noun
агроғалым	noun
агроғылым	noun
агроегіншілік	noun
агроереже	noun
агрожәрдем	noun
агрозауыт	noun
агрозоотехникалық	adj
агрокешен	noun
агроклиматология	noun
агроклиматтық	adj
агролесомелиоратор	noun
агролесомелиорация	noun
агромаксимум	noun
агромелиоратор	noun
агрометеорология	noun
агрометр	noun
агроминимум	noun
агроном	noun
агрономдық	
агрономия	noun
агрономиялық	adj
агронұсқау	noun
агрооқу	noun
агроөнеркәсіп	noun
агроөнеркәсіптік	adj
агропункт	noun
агротәсіл	noun
агротехник	noun
агротехника	noun
агротехникалық	adj
агроүйірме	noun
агрофизика	noun
агрофизикалық	adj
агрохимия	noun
агрохимиялық	adj
агрошара	noun
агроэкология	noun
агроэкологиялық	adj
аға	noun
аға-іні	noun
Ағадыр	noun
ағажан	noun
ағай	noun
ағайдай	noun
ағайын	noun
ағайын-ауқым	noun
ағайын-жегжат	noun
ағайын-жекжат	noun
ағайын-жұрағат	noun
ағайын-жұрт	noun
ағайын-туған	noun
ағайын-тума	noun
ағайын-туыс	noun
ағайынгершілік	noun
ағайындас	adj
ағайындасу	verb
ағайынды	noun
ағайынды-қарындас	noun
ағайындық	noun
ағайынсу	verb
ағайынсыну	verb
ағайыншыл	adj
ағайыншылау	verb
ағайыншылдық	noun
ағайыншылық	noun
ағал-жағал	adj
ағалау	verb
ағалы	adj
ағалы-қарындас	noun
ағалы-қарындасты	adj
ағалы-інілі	adv
ағалық	noun
ағамдай	adv
ағараң	noun
ағараң-ағараң	adj
ағараңдату	verb
ағараңдау	verb
ағарған	adj
ағарғанша	adv
ағартатын	adj
ағартқы	noun
ағартқыш	noun
ағарттыру	verb
ағарту	verb
ағартушы	noun
ағартушы-ұстаз	noun
ағартушылық	noun
ағартық	verb
ағартылған	adj
ағартылмаған	adj
ағартылу	noun
ағартысу	noun
ағару	verb
ағарыңқы	adj
ағасұлтан	noun
ағасыну	verb
ағат	adj
ағатай	noun
ағатайлау	verb
ағатсыз	adj
ағаттау	adj
ағаттық	noun
ағатын	adj
ағауыз	noun
ағаш	noun
ағаш-тұқым	noun
ағашат	noun
ағашаяқ	noun
ағашжегі	noun
ағашкеміргіш	noun
ағашкеміргіштер	noun
ағашкөмір	noun
ағашқұлақ	noun
ағаштай	adv
ағаштандыру	verb
ағаштану	noun
ағаштұқымы	noun
ағашты	adj
ағашты-бұталы	adj
ағаштілгіш	noun
ағашшы	noun
ағашшырмауық	noun
ағеке	noun
ағза	noun
ағзалық	adj
ағзам	adj
ағзаша	noun
ағлақ	noun
ағлөп	noun
ағу	verb
ағуа	noun
ағуалау	verb
ағуашы	noun
ағузы	verb
ағушылық	noun
ағұрық	noun
ағұсақ	noun
ағызатын	adj
ағызғыш	noun
ағыздыру	verb
ағызу	verb
ағызылатын	adj
ағызылу	verb
ағызып-тамызу	verb
ағызысу	verb
ағыл-тегіл	adv
ағылмалы	adj
ағылту	verb
ағылу	verb
ағылшын	noun
ағылшынтілді	adj
ағылшынша	adj
ағылшыншыл	adj
ағылшыншылдық	noun
ағым	noun
ағымда	noun
ағымдағы	adj
ағын	noun
ағында	noun
ағындату	verb
ағындау	verb
ағынды	adj
ағындылық	noun
ағынсыз	adj
ағыншыл	adj
ағыны	noun
ағып	adv
ағып-таму	adv
ағып-тамып	adv
ағыс	noun
ағыссыз	adj
ағысты	adj
ағытқызу	verb
ағытқыш	adj
ағытпа	noun
ағытпалы	adj
ағыттыру	verb
ағыту	verb
ағытулы	adj
ағытылған	adj
ағытылу	verb
ағытысу	verb
ада	noun
ада-гүде	adv
ада-жұда	adv
адажио	noun
адай	noun
адақ	noun
адақталу	noun
адақтасу	verb
адақтату	verb
адақтау	verb
адал	adj
адалау	verb
адалбақан	noun
адалдану	verb
адалдау	verb
адалдық	noun
адалниеттілік	noun
адалсу	verb
адалсыну	verb
адам	noun
адам-ау	noun
адам-күн	noun
адам-сағат	noun
Адамата	noun
адамата	noun
адамбаққысыз	adj
адамгершілік	noun
адамгершілікпен	adv
адамгершіліксіз	adj
адамгершіліксіздік	noun
адамгершілікті	noun
адамдай	adj
адамдарша	adv
адамдық	noun
адамзат	noun
адамзаттық	adj
адамның	adj
адампішінділер	noun
адамсит	noun
адамсу	verb
адамсүйгіштік	noun
адамсымақ	adj
адамсыну	verb
адамсыту	verb
адамтану	noun
адамтанушы	noun
адамша	adv
адамшылық	noun
аданас	noun
адаптация	noun
адаптер	noun
адаптометр	noun
адарғы	noun
адарғылау	verb
адас	noun
адасқақ	noun
адасқан	adj
адасқандық	noun
адасқызу	verb
адасқыш	adj
адастыру	verb
адасу	verb
адасушылық	noun
адат	noun
адау-қадау	noun
адвентив	noun
адвербиалдану	noun
адвербиалды	adj
адвокат	noun
адвокаттық	adj
адвокатура	noun
адекват	adj
адекваттық	adj
аденома	noun
аджар	noun
аджарлық	adj
адиабаттық	adj
администратор	noun
адмирал	noun
адмиралдық	adj
адмиралтейство	noun
адреналин	noun
адрес	noun
адресант	noun
адресат	noun
адсорбент	noun
адсорбция	noun
адуын	adj
адуындану	verb
адуындату	verb
адуындау	verb
адуынды	adj
адуындық	noun
адуындылық	noun
адъективтену	noun
адъективті	adj
адъюнкт	noun
адъютант	noun
адъютанттық	adj
адыгей	noun
адым	noun
адымдағыш	noun
адымдап	adv
адымдату	verb
адымдау	verb
адымдаушы	noun
адымдауыш	noun
адымды	adj
адын	noun
адыр	noun
адыр-адыр	adj
адыр-бұдыр	adj
адыр-бұдырлы	adj
адыр-бұдырлық	adj
адыр-гүдір	adv
адыра	noun
адырайған	adj
адырайту	verb
адырақ	noun
адырана	noun
адыраң-адыраң	adv
адыраңдасу	verb
адыраңдату	verb
адыраңдау	verb
адыраңдық	noun
адыраспан	noun
адыраю	verb
адырлы	adj
адырлы-бұдырлы	adj
адырлық	noun
адырмақ	noun
адырмақ-бұдырмақ	adj
адырмақты	adj
адырна	noun
адырсыз	adv
адырсымак	adj
адыршық	adj
ажа	noun
ажайып	adj
ажал	noun
ажал-тажал	adv
ажалдай	adv
ажалды	adj
ажалсыз	adj
ажалсыздық	noun
ажам	noun
ажан	noun
ажапсыну	verb
ажар	noun
ажар-көрік	noun
ажар-сымбат	noun
ажарлағыш	noun
ажарлайтын	adj
ажарландыру	verb
ажарлану	verb
ажарлау	verb
ажарлаушы	noun
ажарлауыш	noun
ажарлы	adj
ажарлы-сымбатты	adj
ажарлылық	noun
ажарсыз	adj
ажарсыздандырылу	verb
ажарсыздану	verb
ажарсыздық	noun
аждаһа	noun
аждаһадай	adv
аждаһаша	noun
ажио	noun
ажиотаж	noun
ажуа	noun
ажуа-мазақ	noun
ажуа-мысқыл	noun
ажуа-сықақ	noun
ажуаласу	verb
ажуалау	verb
ажуалы	adj
ажуалық	adj
ажуасыз	adj
ажуашыл	adj
ажуашылдық	noun
ажүн	noun
ажым	noun
ажымдану	verb
ажырағысыз	adj
ажырағыштық	noun
ажырайған	adj
ажырайту	verb
ажырайтын	adj
ажырайтындық	adj
ажырайысу	verb
ажырамай	adv
ажырамайтын	adj
ажырамалы	adj
ажырамас	adj
ажырамдылық	noun
ажырасқан	adj
ажырастыру	verb
ажырасу	verb
ажыратқы	adj
ажыратқызу	verb
ажыратқыш	noun
ажыратқыштық	adj
ажыратпай	adv
ажыраттыру	verb
ажырату	verb
ажыратушы	noun
ажыратылмайтын	adj
ажыратылу	verb
ажырау	verb
ажыраю	verb
ажырғы	adj
ажырық	adj
ажырым	noun
аз	adv
аз-аз	adv
аз-аздан	adv
аз-аздап	adv
аз-ақ	adv
аз-кем	adv
аз-көп	adv
аз-маз	adv
аз-мұз	adv
аза	noun
аза-мұң	noun
азагер	noun
азагүл	noun
азайған	adj
азайғыш	noun
азайтқыш	noun
азайттыру	verb
азайту	verb
азайтылған	adj
азайтылу	verb
азайтыңқырау	adj
азалану	verb
азалау	verb
азалы	adj
азамат	noun
азаматтай	adj
азаматтық	noun
азаматша	noun
азаматшылық	noun
азан	noun
азан-қазан	noun
азанама	noun
азанғы	adj
азанда	noun
азандату	verb
азандау	verb
азандық	adj
азаннан	adv
азаншы	noun
азап	noun
азап-бейнет	noun
азап-қорлық	noun
азапкер	noun
азапсыз	adj
азапта	adj
азапталу	verb
азаптандыру	verb
азаптану	verb
азаптанушылық	noun
азаптанып	adv
азаптату	verb
азаптау	verb
азаптаушы	noun
азаптаушылық	noun
азапты	adj
азар	noun
азарда-безер	adv
азарлану	verb
азарлау	verb
азасыз	adj
азат	adj
азатбас	noun
азатжол	noun
азаткер	noun
азаттау	verb
азаттық	noun
азатшы	noun
азатшыл	adj
азатшылық	noun
азаю	verb
азаюшы	noun
азаюшылық	noun
азбан	noun
азбандық	noun
азбанқұл	noun
азбар	noun
азбеніш	noun
азған	adj
азған-тозған	adj
азғана	adv
азғантай	noun
азғын	adj
азғын-тозғын	adj
азғындаған	adj
азғындану	verb
азғындар	noun
азғындату	verb
азғындау	verb
азғындаушылық	noun
азғындауы	noun
азғындық	noun
азғырғыш	noun
азғырғыштық	noun
азғыру	verb
азғырушы	noun
азғырушылық	noun
азғырылған	adj
азғырылу	verb
азғырынды	noun
азғырып-жазғыру	verb
аздаған	adv
аздан-аздан	adv
аздап	adv
аздап-аздап	adv
аздату	verb
аздау	adv
азды-кем	adv
азды-кемді	adv
азды-көпті	noun
аздық	noun
аздыратын	adj
аздырғыш	adj
аздырма	noun
аздырту	verb
аздыру	verb
аздырушы	noun
аздырушылық	noun
аздырып-тоздыру	verb
азимут	noun
Азия	noun
азиялық	noun
азқылтықты	
азқылтықтылар	noun
азобояғыш	noun
азобірігу	noun
азокірнелер	noun
азоқосылыс	noun
азоқұраушылар	noun
азот	noun
азотсіңіруші	noun
азотталу	verb
азоттандырушы	noun
азоттану	verb
азоттау	verb
азотты	adj
азоттық	adj
азошәует	noun
азсынбау	verb
азсынған	adj
азсыну	verb
азсынушылық	noun
азу	verb
азуағаш	noun
азулану	verb
азулау	verb
азулы	adj
азулылық	adj
азусыз	adj
азусыздық	noun
азушылық	noun
азшылық	noun
азық	noun
азық-түлік	noun
азық-түліктік	adj
азықбулауыш	noun
азықжуғыш	noun
азықсыз	adj
азықсыздық	noun
азықсырау	noun
азықтандыру	verb
азықтану	verb
азықты	adj
азықтық	adj
азықхана	noun
азықцех	noun
азын-аулақ	adv
азын-шоғын	adv
азынаған	adj
азынасу	verb
азынату	verb
азынау	verb
азынаулақ	noun
азында	noun
азыңқы	adj
азып	adj
азып-тозған	adj
азып-тозу	verb
азып-тозушылық	noun
азырақ	adv
азырқанбау	noun
азырқану	verb
ай	noun
Ай	noun
ай-жай	adv
ай-түй	adv
ай-шай	noun
ай-шайсыз	adv
айбалдақ	noun
айбалдырған	adj
айбалта	noun
айбалталы	adj
айбалық	noun
айбар	adj
айбарақ	noun
айбарланған	adj
айбарландыру	verb
айбарлану	verb
айбарлы	adj
айбарлылық	noun
айбарсыз	adj
айбарсыздық	noun
айбат	noun
айбатмия	noun
айбатсыз adj
айбатсыздық	noun
айбаттандыру	verb
айбаттану	verb
айбатты	adj
айбаттық	noun
айбаттылық	noun
айбық	adj
айбын	noun
айбынды	adj
айбындылық	noun
айбындыру	verb
айбынсыз	adj
айбынсыздық	noun
айбынту	verb
айбыну	verb
айва	noun
айгөлек	noun
айгүл	noun
айғабақ	noun
айғай	noun
айғай-аттан	noun
айғай-сүрен	noun
айғай-сүрең	noun
айғай-ұйғай	noun
айғай-шу	noun
айғайлаған	adj
айғайласу	verb
айғайлату	verb
айғайлау	verb
айғайсыз	adv
айғайшы	noun
айғайшыл	adj
айғақ	noun
айғақкер	noun
айғақсыз	adj
айғақсыздық	noun
айғақталу	verb
айғақтама	noun
айғақтату	verb
айғақтау	verb
айғақтаушы	noun
айғақты	adj
айғақтылық	noun
айғақшы	noun
айғыз	noun
айғыз-айғыз	adj
айғыздаған	adj
айғыздалған	adj
айғыздалу	verb
айғыздану	verb
айғыздату	verb
айғыздау	verb
айғыр	noun
айғыржуа	noun
айғырқияқ	noun
айғырлық	adj
айғырсасыр	noun
айда	verb
айдағыш	adj
айдай	adv
айдайтын	
айдақ-жайдақ	adj
айдақ-сайдақ	adv
айдақтату	verb
айдала	noun
айдалатын	adj
айдалған	adj
айдалмаған	adj
айдалу	verb
айдалушы	noun
айдалыну	verb
айдалып	adv
айдам	noun
айдама	noun
айдамал	adj
айдамалау	verb
айдапсал	adj
айдар	noun
айдарланған	adj
айдарлы	noun
айдарман	noun
айдарсыз	adj
айдарша	adv
айдаршөп	noun
айдаршық	noun
Айдасан	noun
айдасу	verb
айдатқызу	verb
айдаттыру	verb
айдату	verb
айдау	verb
айдаулы	adj
айдаусыз	adj
айдаушы	noun
айдауыл	noun
айдауыш	adj
айдаһар	noun
айдаһардай	adj
айдаһарша	adv
айды-айынша	adv
айдын	noun
айдындай	adj
айдындану	verb
айдынды	adj
айдынсыз	adj
айдың	adj
айжарық	noun
айкезбе	noun
айкидо	noun
айкидошы	noun
айқабақ	noun
айқай	noun
айқай-даңғаза	noun
айқай-қиқу	noun
айқай-сүрен	noun
айқай-ұйқай	noun
айқай-ұран	noun
айқай-шу	noun
айқайлағыш	noun
айқайлап-ұйқалау	verb
айқайласу	verb
айқайлату	verb
айқайлау	verb
айқайлы	adj
айқайсыз	adv
айқайшы	noun
айқайшыл	adj
айқайшылдық	noun
айқайың	noun
айқаласу	verb
айқалату	verb
айқалау	verb
айқара	adv
айқару	verb
айқарылу	adj
айқас	noun
айқасқан	adj
айқаспа	noun
айқаспалы	adj
айқастыру	verb
айқастырылу	verb
айқасу	verb
айқұлақ	noun
айқын	adj
айқындағыш	noun
айқындалу	verb
айқындама	noun
айқындану	verb
айқындату	verb
айқындау	verb
айқындаушы	
айқындауыш	noun
айқындық	noun
айқындылық	noun
айқынырақ	noun
айқыш	adj
айқыш-ұйқыш	adj
айқыш-ұйқыштану	
айқышталу	noun
айқыштану	verb
айқыштату	verb
айқыштау	verb
айқышты	adj
айла	noun
айла-амал	noun
айла-әдіс	noun
айла-әрекет	noun
айла-қулық	noun
айла-тәсіл	noun
айла-тұзақ	noun
айла-шарғы	noun
айла-шарғылы	adj
айлакер	noun
айлакерлік	noun
айлакес	noun
айлакестік	noun
айлақ	noun
айлақор	noun
айлақорлық	adj
айлақтау	verb
айлақты	adj
айлақтық	adj
айлақылану	verb
айлалау	verb
айлалы	adj
айлалық	noun
айлалылық	noun
айланкес	adj
айлант	noun
айлану	verb
айланшөп	noun
айланысу	verb
айлап	adv
айлап-апталап	adv
айлап-жылдап	adv
айлапат	adj
айлас	adj
айлас-мұңдас	adj
айласыз	adj
айласыздық	noun
айлауық	noun
айлашы	noun
айлашыл	noun
айлы	adj
айлық	adj
айма-ай	adv
аймақ	noun
аймақаралық	adj
аймақкөл	noun
аймақтану	verb
аймақты	adj
аймақтық	adj
аймалақ	noun
аймаласу	verb
аймалату	verb
аймалау	verb
аймандай	adj
аймауыт	noun
аймауыттай	adj
аймыш-ұймыш	adj
аймыштау	verb
аймышты	adj
аймышы	noun
айна	noun
айнадай	adj
айнакөз	noun
айнала	noun
айнала-төңірек	noun
айналадағы	adj
айналайын	noun
айналақтау	verb
айналасы	noun
айналасында	prep
айналау	noun
айналғыш	noun
айналдыра	prep
айналдырғылау	verb
айналдырғыш	adj
айналдырма	noun
айналдыру	verb
айналдырушы	noun
айналдырылу	verb
айналдырып	adv
айналқастау	verb
айналма	noun
айналмақ	noun
айналмалы	adj
айналмалылық	noun
айналсоқ	noun
айналсоқтату	verb
айналсоқтау	verb
айналту	verb
айналу	verb
айналушы	noun
айналшақ	adj
айналшық	noun
айналшықтау	verb
айналы	adj
айналық	adj
айналым	noun
айналымды	adj
айналымдық	adj
айналымдылық	noun
айналып-толғану	verb
айналыс	noun
айналыстыру	verb
айналысу	verb
айналысушы	noun
айналысушылық	noun
айнам	noun
айнамұз	noun
айнаш	noun
айнаша	noun
айну	verb
айнығыш	adj
айнығыштық	noun
айнымайтын	adj
айнымал	adj
айнымалы	adj
айнымалылық	noun
айнымас	adj
айнымау	verb
айнытқызу	verb
айнытпай	adv
айнытпау	verb
айныттыру	verb
айныту	verb
айпап-жайпау	verb
айпара	noun
айпарадай	adj
айран	noun
айран-асыр	noun
айран-шалап	noun
айрандай	adj
айранкөз	adj
айранкөздену	verb
айрауық	noun
айрық	noun
айрықша	adj
айрықшаланған	adj
айрықшалану	verb
айрықшалық	noun
айрылған	adj
айрылмайтын	adj
айрылмас	adj
айрылу	verb
айрылыс	noun
айрылысқан	adj
айрылысу	verb
айсберг	noun
айсор	noun
айсорлық	adj
айсыз	adj
айсырға	noun
айт	noun
айт-айт	noun
айт-түй	noun
айт-үйт	noun
айт-шу	noun
айт-шулеу	verb
айта-айта	adv
айтақ	noun
айтақсыз	adj
айтақтату	verb
айтақтау	verb
айтақтаушы	noun
айтақшы	noun
айтақшыл	adj
айтақыр	adj
айталық	misc
айтар-айтпаста	adv
айтар-айтпастан	adv
айтарлық	adj
айтарлықтай	adj
айтқандай	adv
айтқызу	verb
айтқысыз	adj
айтқыш	noun
айтпақшы	adv
айтпау	verb
айтсаңыздаршы	verb
айттату	verb
айттау	verb
айттық	verb
айттыру	verb
айттырулы	adj
айттырусыз	adj
айттырушы	noun
айттырылу	verb
айттырысу	verb
айту	verb
айтулы	adj
айтусыз	adj
айтушы	adj
айтуынша	noun
айтұяқ	noun
айтшы	verb
айтшыласу	verb
айтшылау	verb
айтылатын	adj
айтылған	adj
айтылмыш	adj
айтылу	verb
айтылыс	noun
айтымпаз	noun
айтып	verb
айтып-айтпай	adv
айтыс	noun
айтыс-жанжал	noun
айтыс-керіс	noun
айтыс-талас	noun
айтыс-тартыс	noun
айтыс-тартыссыз	adv
айтыс-тартысты	adj
айтыскер	noun
айтыскерлік	noun
айтысқұмар	noun
айтысқұмарлық	noun
айтыссыз	adv
айтыстыру	verb
айтысу	verb
айтысушы	noun
айтысып-тартысу	verb
айуан	noun
айуанат	adj
айуандай	adj
айуандық	noun
айуандықпен	adv
айуанша	adv
айуаншылық	noun
айхай	noun
айһай	noun
айшалғы	noun
айшанақ	noun
айшолпы	noun
айшөрек	noun
айшық	noun
айшықсыз	adj
айшықталу	verb
айшықтама	noun
айшықтану	verb
айшықтату	verb
айшықтау	verb
айшықты	adj
айшықтылық	noun
айшылық	adj
айы-күні	noun
айығатын	adj
айығу	verb
айыз	adj
айық	adj
айыққан	adj
айықпаған	adj
айықпай	adv
айықпайтын	adj
айықпайынша	noun
айықтыратын	adj
айықтырғыш	noun
айықтыру	verb
айыл	noun
айыл-тартпа	noun
айыл-тұрман	noun
айылбас	noun
айылдау	verb
айылды	adj
айылдық	adj
айылжапырақ	noun
айылжуа	noun
айылқияқ	noun
айылқұр	noun
айылым	noun
айым	noun
айым-ау	noun
айым-қайым	noun
айына	noun
айында	adv
айында-жылында	adv
айып	noun
айып-алаңы	noun
айып-анжы	noun
айып-аралығы	noun
айып-күнә	noun
айып-кінә	noun
айып-шам	noun
айыпақы	noun
айыпдоп	noun
айыпкер	noun
айыпкерлік	noun
айыппұл	noun
айыпсыз	adj
айыпсыздық	noun
айыпсыну	verb
айыптағушылық	noun
айыпталу	verb
айыпталушы	noun
айыптас	noun
айыптату	verb
айыптау	verb
айыптаушы	noun
айыптаушылық	noun
айыпты	adj
айыптық	adj
айыптылық	noun
айыпшыл	adj
айыр	noun
айыр-айқас noun
айыратын	adj
айырбақай	noun
айырбас	noun
айырбасқор	noun
айырбасталатын	adj
айырбасталу	verb
айырбасталым	noun
айырбастампаз	noun
айырбастату	verb
айырбастау	verb
айырбасу	noun
айырбез	adj
айырғы	noun
айырғысыз	adv
айырғыш	noun
айырқұйрық	noun
айырлану	verb
айырлау	verb
айырлы	adj
айырма	noun
айырмалы	adj
айырмалық	adj
айырмасыз	adj
айырмашылық	noun
айырмүйіз	noun
айырмүіз	noun
айырөркеш	noun
айырсадақ	noun
айырт	noun
айырту	verb
айыртушы noun	
айыртұяқ noun	
айыртұяқты	adj
айыру	verb
айырулы	adj
айырушы	noun
айырушылық noun
айырша	adj
айыршық	noun
айырық	noun
айырықсыз adj
айырықты	adj
айырылатын	adj
айырылған	adj
айырылғандай	adj
айырылмайтын	adj
айырылмас	adj
айырылмастан	adv
айырылмастық	noun
айырылу	verb
айырылыс	noun
айырылысу	verb
айырым	adj
айырымдау	noun
айырып-қосқыш	noun
айырыс	noun
айырысу	verb
айырысушы	noun
академизм	noun
академизмдік	noun
академик	noun
академия	noun
академиялық	adj
акация	noun
акбар	adj
аквакешен	noun
акваланг	noun
аквалангшы	noun
аквамарин	noun
акванавт	noun
акварель	noun
акварельді	adj
акварельші	noun
аквариум	noun
акватория	noun
акведук	noun
аквилон	noun
аккомпанемент	noun
аккомпаниатор	noun
аккорд	noun
аккордеон	noun
аккордеоншы	noun
аккордтық	adj
аккредитив	noun
аккредитивтеу	verb
аккредитивті	adj
аккредитивтік	adj
аккредитивтіркелген adj	
аккредиттелген	adj
аккредиттелу	verb
аккредиттеу	verb
аккузатив	noun
аккумулятор	noun
аккумуляторлы	adj
аккумуляция	noun
аккумуляциялану	verb
аккумуляциялау	verb
аккумуляциялық	adj
акмеизм	noun
акр	noun
акрил	noun
акро	noun
акробат	noun
акробатика	noun
акробатикалық	adj
акробаттық	adj
акроним	noun
акроөлең	noun
акропольnoun	
аксельбант noun	
аксессуар	noun
аксиома	noun
аксиомалық	adj
аксиоматикалық	adj
аксирис	noun
акт	noun
акт-ереже noun	
актер	noun
актерлік	adj
актив	noun
активист	noun
активтелу	verb
активтенген	adj
активтендіру	verb
активтендірушілік	noun
активтендірілу	verb
активтену	verb
активтеу	verb
активті	adj
активтік	noun
актиний	noun
актиния	noun
актриса	noun
актуалды	adj
актуалдық	noun
актуальдандыру	verb
актілену	verb
актілеу	verb
актілі	adj
актілік	adj
акула	noun
акупунктура noun	
акустика noun
акустикалық	adj
акушер	noun
акушерка	noun
акушерлік	adj
акцент	noun
акцентология	noun
акцентсіз	adv
акценттеу	verb
акцентуация	noun
акцентуациялық	adj
акцепт	noun
акцептеу verb	
акцептор	noun
акцепттелген	adj
акцепттелу	verb
акцептік	adj
акцесті	adj
акциденттік	adj
акциз	noun
акцизделу	verb
акциздік	adj
акцизсіз	adj
акциология	noun
акционер	noun
акционерлік	adj
акция	noun
Ақ	adj
ақ	adj
ақ-қара	adj
ақаба	noun
ақай	adj
ақай-тоқай adj	
ақайран	noun
ақайрандану verb	
ақайту	verb
ақалақшы noun	
ақалтеке adv	
ақан	noun
ақаншы	noun
ақаң	noun
ақар-шақар	adj
ақарлы-шақарлы	adj
ақау	noun
ақаулану	verb
ақаулы	adj
ақаулық	noun
ақаулылық noun	
ақаусыз	adj
ақаусыздық	noun
ақаутапқы noun	
ақауыз	adj
ақаю	verb
ақбайпақ noun	
ақбайтал noun	
ақбақай	noun
ақбалшық noun	
ақбалық	noun
ақбас	noun
ақбасшөп noun	
ақбата	noun
ақбауыр	noun
ақбидай	noun
ақбикеш	noun
ақбоз	noun
Ақбозат	noun
ақбөкен	noun
ақбөртелену verb	
ақбұғы	
ақбұзаубас	
ақгвардия	adj
ақгвардияшыл	noun
ақгүл	noun
ақгүлді	adj
ақдабы	noun
ақдегелек noun	
ақжағал	adj
ақжағалақ noun	
ақжағалдану	verb
ақжайма	noun
ақжал	noun
ақжалбыз adj	
ақжапалақ	noun
ақжапырақ	noun
Ақжар	noun
ақжарқын	noun
ақжарқындылық	noun
ақжауын	noun
ақжелек	noun
ақжелкек noun	
ақжелкен noun	
ақжем	noun
ақжемдену verb	
ақжиде	noun
ақжол	noun
ақжолтай	adj
ақжуа	noun
ақжусан	noun
ақжүгері noun	
ақжүзген noun	
ақжүрек	adj
ақжүректік	noun
ақзон	noun
ақи	adj
ақи-тақи adv	
ақиқат	noun
ақиқаттау	verb
ақиқаттық	noun
ақиқаттылық	noun
ақиқатшыл	adj
ақиқатшылдық	noun
ақиқаты	adv
ақиқатында	adv
ақилану	verb
ақирет	noun
ақиреттік	adj
ақиту	verb
ақиық	adj
ақиысу	verb
ақию	verb
ақкекілік	
ақкекіре	noun
ақкелін	noun
ақкеріш	noun
ақкеріштену verb	
ақкес	noun
ақкиіз	noun
ақкөбелек noun	
ақкөде	noun
ақкөз	adj
ақкөздену	verb
ақкөйлек noun	
ақкөңіл	adj
ақкөңілді	adj
ақкөңілдік	noun
ақкөңілділік	noun
ақкөңілділіктен	noun
ақкөш	noun
ақкүйе	noun
ақкүлте	noun
ақкіс	noun
аққаз	noun
аққайнар noun	
аққайрақ noun	
аққайран noun	
аққайың	noun
аққайыңшөп noun	
аққала	noun
аққалақ	noun
аққанат	noun
аққандылық	noun
аққаңбақ noun	
аққаптал noun	
аққарағай noun	
аққарқара noun
аққат	noun
аққатпа	noun
аққия	noun
аққодал	noun
аққой	noun
аққолтықnoun	
аққонақ	noun
аққоңырбасnoun	
Аққорғанnoun	
аққоян	noun
аққу	noun
Аққу	noun
аққурай	noun
аққұба	noun
аққұбалау verb	
аққұбаша	noun
аққұйрық	noun
аққұла	adv
аққұлақ	noun
аққұман	noun
аққұмырсқа	noun
аққұр	noun
аққұс	noun
аққұтан	noun
аққылтан noun	
аққылтық adj	
аққыш	adj
аққыштық adj	
ақлақ	noun
ақләйлек noun	
ақмағамбет	noun
ақмақтанып	adv
ақмақтарша	noun
ақмақтықпен	adv
ақмамық	noun
ақмарал	noun
ақмарқа	noun
ақмарту	verb
ақмасақтық	noun
ақмия	noun
ақмұрт	noun
ақмыя	noun
ақнабат	noun
ақнауат	noun
ақнәсілді adj	
ақниет	noun
ақниетті adj	
ақот	noun
ақпа	adj
ақпақұлақ noun	
ақпақұлақтану	verb
ақпалау	verb
ақпан	noun
ақпан-тоқпан	adv
ақпандату	verb
ақпар	noun
ақпар-кітапша	noun
ақпарат	noun
ақпаратнама	noun
ақпараттандыру	verb
ақпараттану	noun
ақпараттау	verb
ақпараттық	adj
ақпараттық-анықтамалық	adj
ақпараттық-талдау noun	
ақпараттылық	noun
ақпарлау	verb
ақпартану	verb
ақпартізім	noun
ақпаршы	noun
ақпатаяқ noun	
ақпейіл	adj
ақпейілді	adj
ақпейілділік	noun
ақсабақты	adj
ақсағал	noun
Ақсай	noun
ақсайит	noun
ақсақ	adj
ақсақ-тоқсақ	adj
ақсақал	noun
ақсақалдай	noun
ақсақалды	adj
ақсақалдық	adj
ақсақтық	noun
ақсаң	adj
ақсаңдату	verb
ақсаңдау	verb
ақсаңқырау	verb
ақсаңырауқұлақ	noun
ақсап-тоқсап	adv
ақсарағат	noun
ақсарбасnoun	
ақсары	noun
ақсарылау verb	
ақсату	verb
ақсау	verb
ақсаусақ	noun
ақсаусақтық	adj
ақсексеуіл noun	
ақселеу	verb
ақсерке	noun
ақсиған	adj
ақсирақ	noun
ақсирақтану	verb
ақситу	verb
ақсию	verb
ақсора	noun
ақсорпа	noun
ақсөл	noun
ақсөңке	noun
ақсу	noun
Ақсуат	noun
ақсұлама noun	
ақсұңқар noun	
ақсұңқардай 	adv
ақсұп	noun
ақсүйек	noun
ақсүйектер	noun
ақсүйектік	adj
ақсүт	noun
ақсүттену verb	
ақсыну	verb
ақсыр	adj
ақсырау	verb
ақсырғақ noun	
ақсырттан noun	
ақта	noun
ақтабан	noun
ақтағыр	noun
ақтады	verb
ақтайтын 	adj
ақтал	noun
ақталған	adj
ақталқан	adj
ақталмаған	adj
ақталу	verb
ақталушы	noun
ақтамақ	noun
ақтамақгүл	noun
ақтамыр	noun
ақтан	noun
ақтаңдақ	noun
ақтаңдақтану	verb
ақтаңдақтар	noun
ақтарғыш	noun
ақтармалау	verb
ақтарту	verb
ақтару	verb
ақтары	noun
ақтарылған	adj
ақтарылу	verb
ақтарыну	verb
ақтарып-төңкеру	verb
ақтарып-төңкерістіру	verb
ақтарыс	noun
ақтарыстыру	verb
ақтарысу	verb
ақтас	noun
ақтаспа	noun
ақтаспашөпnoun	
ақтасу	verb
ақтатқызу	verb
ақтаттыру	verb
ақтату	verb
ақтау	verb
ақтауқалақай noun	
ақтаулы	adj
ақтаутанnoun	
ақтаушы	noun
ақташы	noun
ақтаяқ	noun
ақтәңді	adj
ақтерек	noun
ақтиін	noun
ақтоған	noun
ақтопалаңnoun	
ақторға	noun
ақторғай	noun
Ақтөбе	noun
ақтөс	noun
ақтұйғын noun	
ақтұмсық noun	
ақтұнжыр noun	
ақтұңғиық noun	
ақтұт noun
ақтұяқ	noun
ақтүйежоңышқа	noun
ақтүйнек	noun
ақтүйіршік	noun
ақтүлкі	noun
ақтүн	noun
ақтүтек	noun
ақтүтектену	verb
ақты	verb
ақты-көкті adj	
ақты-қара adj	
ақты-қаралы	adj
ақты-қызылды	adj
ақтығында	adv
ақтық	noun
ақтылы	adj
ақтылы-қаралы	adj
ақтырна	noun
ақтышқақ noun	
ақтышқан noun	
ақтігер	noun
ақтікен	noun
ақуыз	noun
ақуызды	adj
ақұнтақ	noun
ақұрық	noun
ақүй	noun
Ақүй	noun
ақүйлі	adj
ақүрпек	adj
ақүрпектену	verb
ақүртек	noun
АҚШ	noun
ақша	noun
ақша-несие noun	
ақша-салық	noun
ақша-сауда	noun
ақша-тауар noun	
ақшабақ	noun
ақшагер	noun
ақшағала	noun
ақшаған	noun
ақшадай	noun
ақшайыр	noun
Ақшақар	noun
ақшақұмар adj	
ақшалай	adv
ақшалай-заттай	adv
ақшалану	verb
ақшалау	verb
ақшалы	adj
ақшам	noun
ақшамсоқыр	noun
ақшаңдақ	noun
ақшаңдақтану	verb
ақшаңдату	verb
ақшаңдау	verb
ақшасанау	noun
ақшасыз	adj
ақшасыздық	noun
ақшатай	noun
ақшатау	verb
ақшатыр	noun
ақшелек	noun
ақшеңгелnoun	
ақшешек	noun
ақшешекше adv
ақшиту	verb
ақшию	verb
ақшоқан	noun
ақшолақ	noun
ақшом	noun
ақшомшы	noun
ақшомыр	noun
ақшөп	noun
ақшуақ	noun
ақшұнақ	noun
ақшыл	adj
ақшылдандыру	verb
ақшылдану	verb
ақшылдау	adj
ақшылдық	noun
ақшылт	adj
ақшылттау	adj
ақшылтым	noun
ақшырайлы	noun
ақшытыр	noun
ақшіл	noun
ақшілік	noun
ақшірік	noun
ақы	noun
ақы-пұл	noun
ақы-пұлсыз	adv
ақық	noun
ақықтау	verb
ақықты	adj
ақыл	noun
ақыл-айла	noun
ақыл-ес	noun
ақыл-естілік	noun
ақыл-кеңес	noun
ақыл-көрік	noun
ақыл-ой	noun
ақыл-өсиет	noun
ақыл-парасат	noun
ақыл-парасаттылық	noun
ақыл-сана	noun
ақылгөй	noun
ақылгөйлік	noun
ақылгөйсу	verb
ақылгөйсіну	verb
ақылға	noun
ақылдас	noun
ақылдасқызу	verb
ақылдастыру	verb
ақылдасу	verb
ақылды	adj
ақылдық	noun
ақылдылық	noun
ақылдымсу	verb
ақылдысымақ	noun
ақылдысыну	verb
ақылман	noun
ақылмандық	noun
ақылмен	adv
ақылсерік	noun
ақылсөз	noun
ақылсыз	noun
ақылсыздану	verb
ақылсыздық	noun
ақылсыну	verb
ақылшы	noun
ақылшы-ұстаз	noun
ақылы	adj
ақылылық noun	
ақымақ	adj
ақымақтанған	adj
ақымақтандыру	verb
ақымақтану	verb
ақымақтау	adj
ақымақтық	noun
ақымақшылық	noun
ақын	noun
ақын-жазушы	noun
ақын-жазушылар	noun
ақындық	adj
ақынжанды	adj
ақынжандылық	noun
ақынсу	verb
ақынсымақ	adj
ақынсыну	verb
ақыр	noun
ақыр-тақыр	adv
ақыр-шек	noun
ақырайту	verb
ақыраңдату	verb
ақыраңдау	verb
ақырап	noun
Ақырап	adv
ақырау	verb
ақыраю	verb
ақырғы	adj
ақырет	noun
ақыреттік	adj
ақырзаман	noun
ақырлау	verb
ақырту	verb
ақыру	verb
ақыры	adv
ақырын	adv
ақырын-ақырын	adv
ақырында	adv
ақырындап	adv
ақырындату	verb
ақырындатылған	adj
ақырындау	verb
ақырындық	noun
ақырынырақ	noun
ақырып-бақыру	verb
ақырып-жекіру	verb
ақырып-зекіру	verb
ақырып-шақыру	verb
ақырысу	verb
ақысыз	adj
ақысыз-пұлсыз	adj
ақыт	noun
ақірімшік	noun
ақэмигрант	noun
ал	misc
ал-дал	noun
ал-сал	noun
ала	adj
ала-бөле	adv
ала-бөтен	adj
ала-құла	adj
ала-құлалық	noun
алааяқ	noun
алабажақ	adj
алабажақтану	verb
алабажақтық	noun
алабажыр	noun
алабалта	noun
алабарқын	adj
алабас	noun
алабота	noun
алабөрту	verb
алабөтен	noun
алабөтендік	noun
алабұға	noun
алабұлбұл	noun
алабұлдыр	noun
алабұлдырық	noun
алабұрту	verb
алабұта	noun
алабүйі	noun
алабүлік	noun
алабүрге	noun
алагеуім	noun
алагеуімдену	verb
алагөбе	noun
алагөбеде	noun
алагөбең	noun
алагүлік	noun
алағай	adj
алаған	adj
алағандық	noun
алағаншық	noun
алағаншықтану	verb
алағаншықтау	verb
алағат	adj
алағұс	noun
алағызу	verb
аладомбай	noun
алажаулы	adj
алажертесер	noun
алай	adv
алай-бұлай	adv
алай-былай	adv
алай-дүлей	noun
алай-түлей	adv
алайда	misc
алайту	verb
алакеуімнен	adv
алакөз	noun
алакөздену	verb
алакөздік	noun
Алакөл	noun
алакөлеңке	noun
алакөлеңкеден	adv
алакөлеңкелену	verb
алакөңіл	noun
алакөңілділік	noun
алакүйек	noun
алакүлтелі	adj
алакүшік	noun
алақ	adj
алақ-алақ	adj
алақ-жалақ	adj
алақ-жұлақ	adj
алақ-салақ	adj
алақаз	noun
алақай	noun
алақайлау	verb
алақан	noun
алақанат	
алақандай	adj
алақандау	verb
алақансоқпақ	noun
алақап	noun
алақарақ	noun
алақарға	noun
алақаудан	noun
алақиғаш	noun
алақоғыр	noun
алақол	adj
алақолдық	noun
алақолдылық	noun
алақоржын	noun
алақтасу	verb
алақтату	verb
алақтау	verb
алақумай	noun
алақұйын noun	
алақұйындану	verb
алақұмай	noun
алақұрт	noun
алақұрттау	verb
алақшы	noun
алақшын	noun
алақызба	noun
алаламай	adv
алаламайтын	adj
алалану	verb
алалату	verb
алалау	verb
алалаушылық	noun
алалы	adj
алалы-құлалы	adj
алалық	noun
алалықсыз	adj
аламай	noun
аламайлау	verb
аламайлы	adj
аламан	noun
аламан-тасыр	noun
аламандау	verb
аламандық	noun
аламық	noun
аламыш	adj
аламыштану	verb
аламыштату	verb
аламыштау	verb
алан	noun
аланды	adj
алаң	noun
алаң-бұлаң	adj
алаң-елең	adj
алаңғасар	adj
алаңғасарландыру	verb
алаңғасарлану	verb
алаңғасарланушылық	noun
алаңғасарланып	adv
алаңғасарлық	noun
алаңғыт	adj
алаңдатарлық	adj
алаңдатпа	noun
алаңдату	verb
алаңдау	verb
алаңдаушылық	noun
алаңдық	noun
алаңқай	noun
алаңқы	adj
алаңсыз	adj
алаңсыздық	noun
алаңша	noun
алаңшық	noun
алаңшыл	adj
алаөкпе	noun
алаөрмекші 	noun
алап	noun
алап-жалап adv	
алапа	noun
алапай	noun
алапай-талапай	noun
алапат	noun
алапаттану	verb
алапатты	adj
алапаттық adj	
алапес	noun
алапестей	adj
алапестену	verb
алапты	adj
аларман	noun
аларту	verb
алару	verb
алас	noun
алас-күлес	noun
алас-қапас	noun
алас-қапаста	noun
алас-құлас	noun
аласа	adj
аласабыр	
аласалау	adj
аласалық	adj
аласапақ	adj
аласапыран	noun
аласапыраншыл	adj
аласарақ	adv
аласарту	verb
аласару	verb
аласат	noun
аласауысқан adj	
аласәуле	noun
аласәулелену	verb
аласпан	noun
аласталған	noun
аласталу	verb
аластату	verb
аластау	verb
аластаушы 	noun
аласуан	noun
аласұрған 	noun
аласұрғызу	verb
аласұрту	verb
аласұру	verb
аласұрыс	noun
аласы	noun
аласы-бересі	noun
аласыз	adj
аласылы	noun
алатаң	adj
алатопалаң	noun
алатұяқ	adj
алатышқан	noun
алатізбекті	adj
алатікен	noun
алау	noun
алау-далау noun	
алау-жалау noun	
алаудай	adv
алаукеуімнен	adv
алаулану	verb
алаулату	verb
алаулау	verb
алаулы	adj
алауоттық	adj
алаурату	verb
алаурау	verb
алауыз	adj
алауыздық	noun
алаш	noun
алаша	noun
алашабыр noun	
алашақ	noun
алашапқын	noun
Алашорда	noun
алашордалық	adj
алашордашы	noun
алашордашыл	adj
алаштау	verb
алашшыл	adj
алаю	verb
алаяқ	noun
алаяқтық	noun
алба-далба	adj
алба-жалба	adj
алба-жұлба	adj
албан	noun
албар	noun
албар-қора	noun
албарлы	adj
албасты	noun
албастыдай	noun
албаты	adv
албау	noun
албыр-жалбыр	adj
албыр-салбыр	noun
албыраған	adj
албырап-жалбырау	verb
албырату	verb
албырау	verb
албырт	adj
албырттану	verb
албырттық	noun
албырту	verb
албыт	noun
албыттану	verb
албыттық	noun
албыту	verb
алгебра	noun
алгебралық	adj
алгебрашы	noun
алгоритм	noun
алгоритмдік	adj
алгоритмизация	noun
алгорифм	noun
алға	prep
Алғабас	noun
алғай-шалғай	noun
алған	verb
алғанша	verb
алғаны	noun
алғау	noun
алғаусыз	adv
алғаш	adv
алғашқы	adj
алғашқыда	adv
алғашқыдай	adv
алғашқылық	noun
алғашқысында	adv
алғы	adj
алғы-бергі	adj
алғызу	verb
алғыншы	adj
алғыр	adj
алғырлық	noun
алғыс	noun
алғысөз	noun
алғыстау	verb
алғысты	adj
алғысхат	noun
алғытөлем	noun
алғытөлемді	adj
алғытөлемдік	adj
алғыш	noun
алғышарт	noun
алғыштау	verb
алда	prep
алда-жалда	adv
алдағы	adj
алдағыш	noun
алдамалау	
алдампаз	noun
алдампаздық	noun
алдамша	noun
алдамшы	adj
алдамшыланған	adj
алдамшылық	noun
алдамыш	adj
алдан	prep
алданған	adj
алданғызу	verb
алданғыш	adj
алдандырту	verb
алдандыру	verb
алдандырушы	noun
алданту	verb
алдану	verb
алданушы	noun
алданыс	noun
алданыш	noun
алданышсыз	adj
алдап	adj
алдап-арбау	verb
алдап-сулау	verb
алдарақ	noun
алдаркөсе	noun
Алдаркөсе	noun
алдаркөселік	adj
алдарқату	verb
алдаспан	noun
алдастыру	verb
алдасу	verb
алдату	verb
алдау	verb
алдау-арбау	verb
алдаусырату	verb
алдаушы	noun
алдаушылық	noun
алдауыш	noun
алдауыштық	adj
алдияр	adj
алдиярлау	verb
алды	prep
алды-алдына	noun
алды-арты	noun
алды-артына	noun
алдым-бердім	noun
алдымен	adv
алдын-ала	adv
алдыналушылық	noun
алдынан	adv
алдында	prep
алдыңгүні	adv
алдыңғы	adj
алдырмай-жұлдырмай	adv
алдырмай-шалдырмай	adv
алдырмайтындық	adj
алдырту	verb
алдыру	verb
алдырушы	noun
алебастр	noun
александрит	noun
алеут	noun
алжа-алжа	adj
алжапқыш	noun
алжапқыштық	noun
алжасқан	adj
алжастыру	verb
алжасу	verb
алжир	noun
алжу	verb
алжұмыр	noun
алжыту	verb
алиби	noun
алидада	noun
ализарин noun	
алимент	noun
алименттік	adj
алкалоид noun	
алкалоидтік 	adj
алкоголизм	noun
алкоголь	noun
алкогольдендіру	verb
алкогольды	adj
алкогольсыз	adj
алкогольсіз	adj
алкүрең	adj
алқа	noun
алқа-қотан	noun
алқа-салқа	adj
алқаби	noun
алқабилік	noun
алқагүл	noun
алқалай	adv
алқалану	verb
алқалау	verb
алқалы	adj
алқалық	adj
алқам-салқам	adj
алқаның	noun
алқап	noun
алқаптану	verb
алқапты	adj
алқаптық adj	
алқау	verb
алқоры	noun
алқызыл	adj
алқызылдану	verb
алқылдау	verb
алқым	noun
алқым-жұлқым	adj
алқымдасу	verb
алқымдату	verb
алқымдау	verb
алқын	noun
алқын-жұлқын	adj
алқынды	noun
алқындыру	verb
алқынту	verb
алқыну	verb
алқыныс	noun
Алла	noun
аллалау	verb
Аллалау	verb
Аллатағала	noun
Аллауакбар	noun
аллашыл	adj
аллашылдық	noun
аллегория	noun
аллегориялық	adj
аллегро	noun
аллергия	noun
аллергиялы	adj
аллергиялық	adj
аллерголог	noun
аллея	noun
аллеялы	adj
аллигатор	noun
аллитерация	noun
аллитеризация	noun
алло	misc
аллограф	noun
аллопат	noun
аллопатия	noun
аллотропия	noun
аллотропиялық	adj
аллофон	noun
аллювий	noun
аллюр	noun
алма	noun
алма-кезек	adv
алма-қоспай	adv
алмаағаш	noun
алмағайып	adj
алмажегі	noun
алмаз	noun
алмазды	adj
алмақ	noun
алмаласу	verb
алмалау	verb
алмалы	adj
алмалы-салмалы	adj
алмас	noun
алмасатын	
алмасқызу	verb
алмасты	adj
алмастыратын	adj
алмастырғыш	noun
алмастырту	verb
алмастыру	verb
алмастырушы	noun
алмастырылатын	adj
алмастырылу	verb
алмасу	verb
алмасушы	noun
алмасушылық	noun
Алматы	noun
алмау	verb
алмауыт	adj
алмұрт	noun
алмұртшөп noun	
алмысақ	noun
алогизм	noun
алоэ	noun
алпамса	noun
алпамсадай	noun
алпар	noun
алпарысу	verb
алпауыт	adj
алпыс	card
алпыс-жетпіс	
алпысыншы	ord
алсын	noun
алтай	noun
алтайлық	noun
алтайы	adj
алтарь	noun
алтатар	noun
алтау	card
алтаулап adv	
алтаумыз num	
алтаяқ	noun
алтаяқты adj	
алты	card
алты-жеті num	
алтыатар	noun
алтыаяқ	noun
алтыбақан	noun
алтыбасар	noun
алтыбұрыш	noun
алтыжақты	adj
алтыкүндік	adj
алтылық	noun
алтын	noun
алтын-валюта	
алтын-күміс	adj
алтынағаш	noun
алтынбалық	noun
алтынгүл	noun
алтындаған	adj
алтындай	adj
алтындалған	adj
алтындалу	verb
алтындану	verb
алтындату	verb
алтындатылған	adj
алтындау	verb
алтындаушы	noun
алтынды	adj
алтынкөз	noun
алтынкүрек	noun
алтынқабақ	noun
алтынтамыр	noun
алтынтой	noun
алтыншар	noun
алтыншы	ord
алтыншыбық	noun
алтыншыдан	
алу	verb
алуа	noun
алуа-шекер	noun
алуан	adj
алуан-алуан adj	
алуан-түрлі	adj
алуан-шекер	adj
алуандас	adj
алужын	noun
алушы	noun
алфавит	noun
алфавитті	adj
алфавитті-жиілік adj	
алфавиттік	adj
алфавиттік-пәндік adj	
алхимик	noun
алхимия	noun
алхимиялық	adj
алхоры	noun
алша	noun
алшайту	verb
алшақ	adj
алшақталу	verb
алшақтану	verb
алшақтату	verb
алшақтау	verb
алшақтық	noun
алшалғыш	noun
алшаң	adj
алшаң-алшаң	adj
алшаңдату	verb
алшаңдау	verb
алшаөрік	noun
алшаю	verb
алшиту	verb
алшию	verb
алшы	verb
алшын	adj
алшындай adj	
алшынкөк noun	
алық	noun
алық-берік	adj
алық-салық	adj
алым	noun
алым-берім	noun
алым-жұлым	adj
алым-салық	verb
алым-салым	noun
алым-шығын	noun
алымды	adj
алымдылық	noun
алымқор	noun
алымқорлық	noun
алымпаз	noun
алымсақ	adj
алымсақ-берімсек adj	
алымсақтық	adj
алымсыз	adj
алымсыздық	noun
алымшы	noun
алымы	noun
алымыр	noun
алымыру	verb
алынбаған	adj
алынбау	verb
алынған	adv
алыну	verb
алып	noun
алып-ұшып	adv
алыпқаш	noun
алыпқашпа	
алыпқашты	noun
алыпсатар	noun
алыпсатарлық	noun
алыпсоқ	noun
алыптай	noun
алыптық	adj
алыпұшпа	adj
алыс	adj
алыс-беріс	noun
алыс-жақын	adj
алыс-жақындық	adj
алыс-жұлыс	noun
алыс-жырақ	adj
алыс-тартыс	noun
алысқа	adv
алыспақ	noun
алыссынбау	verb
алыссыну	verb
алыста	adv
алыстағы	adv
алыстан	adv
алыстату	verb
алыстатылу	verb
алыстау	verb
алыстық	noun
алыстыру	verb
алысу	verb
алысушы	noun
алысып-жұлысу	verb
алысырақ	adv
альбатрос	noun
альбинизм	noun
альбинос	noun
альбом	noun
альбумин	noun
альвеола	noun
альков	noun
альковты	adj
альманах	noun
альмандин	noun
альпентшток	noun
альпиниада	noun
альпинизм	noun
альпинист	noun
альпинистік	adj
альпілік	adj
альт	noun
альтерация	noun
альтернат	noun
альтернативтік	adj
альтернатор	noun
альтернация	noun
альтиметр	noun
альтруизм	noun
альтруист	noun
альтруистік	adj
альтшы	noun
альфа	noun
альфа-бөлшек	noun
альфа-бөлшектер	noun
альфа-сәулелер	noun
альянс	noun
алюминді	adj
алюминий	noun
алюминийлеу	verb
аляска	noun
ам	
амал	noun
Амал	noun
амал-айла	noun
амал-айламен	adv
амал-әрекет	noun
амалдау	verb
амалсыз	adj
амалсыздан	adv
амалсыздық	noun
амалшы	noun
амалшыл	adj
амалшылық	noun
амальгама	noun
амальгамалау	verb
аман	adj
аман-есен	adj
аман-есендік	noun
аман-сау	adj
аман-саулық	noun
аманат	noun
аманаттау	verb
аманаттық	adj
амандастыру	verb
амандасу	verb
амандау	verb
амандық	noun
амандық-саулық	noun
аманшылық	noun
амбар	noun
амбиция	noun
амбразура	noun
амбре	noun
амбулатория	noun
амбулаториялық	adj
амеба	noun
америка	adj
америкалық	noun
американ	noun
американдандырылған	adj
американдық	noun
аметист	noun
аметисті	adj
амиант	noun
амиантты	adj
амин	adj
аминқышқыл	adj
аммиак	noun
аммиакты	adj
аммоний	noun
амнезия	noun
амнистия	noun
амнистияланған	adj
амнистиялау	verb
аморальдық	adj
амортизатор	noun
амортизация	noun
амортизациялау	verb
амортизациялық	adj
аморф	noun
аморфты	adj
аморфтық adj	
ампер	noun
ампер-орам noun	
ампер-сағат 	noun
амперметр	noun
ампир	noun
амплитуда noun	
амплитудалық	adj
амплуа	noun
ампула	noun
ампутация	noun
ампутациялау	verb
ампутациялық	adj
амур	noun
амфибия	noun
амфибрахий 	noun
амфибрахийлік	adj
амфитеатр	noun
амфора	noun
ана	noun
ана-мына prep	
анабазис 	noun
анабио noun
анаграмма	noun
анағұрлым	adj
анада	adv
анадағы	adj
анадағыдай	
анадай	adjpron
анадайда	adv
анадан	adv
анажан	noun
анайы	adj
анайыланту	verb
анайылану	verb
анайылық	noun
анаконда	noun
анақұдай	noun
анал	noun
анализ	noun
анализатор	noun
анализдену	verb
анализдеу	verb
анализдік	adj
аналитика	noun
аналитикалық	adj
аналогия	noun
аналы-балалы	adj
аналық	noun
анальгин	noun
анаморфоз	noun
ананас	noun
анапест	noun
анар	noun
анаргүл	noun
анардай	adj
анартас	noun
анархизм	noun
анархист	noun
анархист-синдикалист	noun
анархистік	adj
анархия	noun
анархиялы	adj
анархиялық	adj
анархо-синдикализм	noun
анастомоз	noun
анасыз	
анатом	noun
анатомдау	verb
анатомдық	adj
анатомия	noun
анатомиялық	adj
анау	adjpron
анау-мынау	adj
анау-мынаусыз	adv
анафора	noun
анахронизм	noun
анахронизмдік	adj
анаш	noun
анаша	noun
анаэроб	noun
анаэробты	adj
ангажемент	noun
ангажементтеу	verb
ангар	noun
ангидрид noun	
ангина	noun
англицизм	noun
англо-американ	noun
англо-американдық adj	
англосакс	noun
анголалык	adj
анголар	noun
ангор	noun
ангстрем	noun
анда	adv
анда-мұнда	adv
анда-санда	adv
андағайлау	verb
андағы-мұндағы	adv
андаза	noun
андай-мұндай	adv
анданте	noun
андату	verb
андау	verb
андронов	noun
андыз	noun
андыз-андыз	adj
андызағаш	noun
андыздату	verb
андыздау	verb
аневризм	noun
аневризма	noun
анекдот	noun
анекдоттық	adj
анемограф	noun
анероид	noun
анестезиолог	noun
анестезиология	noun
анестезия	noun
анестезиялау	verb
анжы	noun
анжыма	noun
анжыр	noun
анжырлану	verb
анилин	noun
анимализм	noun
анималист	noun
анималистік	adj
анимация	noun
анимизм	noun
анион	noun
анис	noun
анкер	noun
анкет	noun
анкеталық	verb
анкеттік	verb
анналы	noun
аннексия	noun
аннексиялану	verb
аннексиялау	verb
аннексияшы	noun
аннотация	noun
аннотациялау	verb
аннотациялық	adj
аннуитеттік	noun
аннуляция	noun
анод	noun
анодтау	verb
анодты	adj
аноксия	noun
аномалия	noun
аноним	noun
анонс	noun
анонстау	verb
анорак	noun
анорганикалық	adj
ансамбль	noun
ансамбльдік	adj
ансар	noun
ант	noun
ант-су	noun
антагонизм	noun
антагонист	noun
антагонистік	adj
анталастыру	verb
анталасу	verb
анталату	verb
анталау	verb
антанта	noun
Антарктида	noun
Антарктика	noun
антарктикалық	adj
антатқан	adj
антбұзар	adj
антбұзушылық	noun
антенна	noun
антенналы	adj
антенналық	adj
антибиоз	noun
антибиотик	noun
антибөлшек	noun
антибөлшектер	noun
антивирустық	adj
антигендік	noun
антигигиеналық	adj
антигитлерлік	adj
антиғаламдастыру verb	
антиғаламдастырушы	noun
антидемократизм	noun
антидемократиялық	adj
антидене	noun
антидүние	noun
антидүниелік	adj
антизат	noun
антиимпериалистік	adj
антиинтеллектуализм	noun
антик	noun
антиквар	noun
антикварлық	adj
антикоммунизм	noun
антикоммунистік	adj
антимагниттік	adj
антимарксистік	adj
антиметатеза	noun
антимилитаризм	noun
антимилитаристік adj	
антимонархиялық	adj
антимоний noun	
антимонополия	noun
антимонополиялық	adj
антиномия	noun
антипартиялық	adj
антипатия	noun
антипатриоттық	adj
антипод	noun
антипозициялық	adj
антисанитариялық	adj
антисанитарлық	adj
антисемит	noun
антисемитизм	noun
антисемиттік	adj
антисептик	noun
антисептика	noun
антисептикалық	adj
антисептиктік	adj
антисоветтік	adj
антисоветші	noun
антитеза	noun
антитезис	noun
антитоксин	noun
антитоксиндік	adj
антифашизм	noun
антифашист	noun
антифашистік	adj
антифеодалдық	adj
антифриз	noun
антихрист	noun
антициклон	noun
антициклондық	adj
антқағаз	noun
антқор	noun
антқорлық	adj
антология	noun
антологиялық	adj
антоним	noun
антонимдік	adj
антоновка	noun
антпен	noun
антракт	noun
антрактілі	adj
антрацит	noun
антрекот	noun
антрепренер	noun
антресоль	noun
антропикалық	adj
антропогендік	noun
антропогенез	noun
антрополог	noun
антропология	noun
антропологиялық	adj
антропометр	noun
антропометрия	noun
антропометриялық	adj
антропоморфизм	noun
антропоним	noun
антропофаг	noun
антропоцентризм	noun
анттас	noun
анттасу	verb
антты	adj
антұрған	adj
анфилада	noun
анхазірет	noun
анхар	noun
анхуза	noun
анчар	noun
анчоус	noun
анша-мұнша	adv
аншлаг	noun
анығында	adv
анығырақ	noun
анық	adj
анық-қанық	noun
анық-танық	noun
анықтағыш	noun
анықталатын	adj
анықталатындық	adj
анықталған	adj
анықталғыш	noun
анықталмаған	adj
анықталмайтын	adj
анықталу	verb
анықтама	noun
анықтама-көрсеткіш	noun
анықтамалық	noun
анықтан-анық	adj
анықтану	verb
анықтап	verb
анықтасу	verb
анықтату	verb
анықтау	verb
анықтаушы	noun
анықтауыш	noun
анықтауыштық	adj
анықтық	noun
анықтылық	noun
анықырақ	noun
аң	noun
аң-таң	noun
аңғал	adj
аңғал-саңғал	adj
аңғалақ	adj
аңғалақтау	verb
аңғалақтық	noun
аңғалдану	verb
аңғалдық	noun
аңғалсақ	adj
аңғалсақтық	noun
аңғалсоқ	adj
аңғалсоқтық	noun
аңғар	noun
аңғар-аңғар	adj
аңғарғыш	adj
аңғарғыштық	noun
аңғарлау	verb
аңғарлы	adj
аңғарсыз	adj
аңғарту	verb
аңғару	verb
аңғарусыз	adv
аңғарылу	verb
аңғарым	noun
аңғарымды	adj
аңғарымдылық	noun
аңғарымпаз	adj
аңғарымпаздық	noun
аңғарысу	verb
аңғырт	adj
аңғыртсу	verb
аңғырттанбау	verb
аңғырттану	verb
аңғырттық	noun
аңғырттықтан	noun
аңғырту	verb
аңдағыш	adj
аңдағыштық	noun
аңдай	adv
аңдалу	verb
аңдамай	adv
аңдар	noun
аңдардың	adj
аңдарлық	adj
аңдасу	verb
аңдатпа	noun
аңдату	verb
аңдау	verb
аңдаусыз	adv
аңдаусызда	adv
аңдаусыздан	adv
аңдаусыздық	noun
аңдаушылық	noun
аңду	verb
аңдулы	adj
аңдусыз	adj
аңдушы	noun
аңдуыл	noun
аңдыған	adj
аңдығыш	noun
аңдысқан adj	
аңдыстыру verb	
аңдысу	verb
аңдыттыру	verb
аңдыту	verb
аңжалақ	adj
аңкалақтау	verb
аңку	verb
аңқ	noun
аңқа	noun
аңқайған adj	
аңқайту	verb
аңқалақтау	verb
аңқаңдау	verb
аңқау	adj
аңқау-аңғал	adj
аңқауланбау	verb
аңқаулану	verb
аңқаулау	adj
аңқаулық	noun
аңқаусу	verb
аңқаусыну	verb
аңқаю	verb
аңқиту	verb
аңқиып-саңқию	verb
аңқию	verb
аңқу	verb
аңқұмар	noun
аңқұмарлық	noun
аңқылдаған	adj
аңқылдақ	adj
аңқылдақтық	noun
аңқылдату	verb
аңқылдау	verb
аңқыту	verb
аңлау-саңлау	adj
аңсағай	noun
аңсағайлану	verb
аңсағайлау	verb
аңсаған	adj
аңсақ	adj
аңсар	noun
аңсату	verb
аңсау	verb
аңсаулы	adj
аңсаушылық	noun
аңсыз	adv
аңсызда	adv
аңсыздық	noun
аңсырату	verb
аңсырау	verb
аңтарылу	verb
аңтарылысу verb	
аңша	noun
аңшы	noun
аңшыл	adj
аңшылау	adj
аңшылық	noun
аңшылықтану noun	
аңыз	noun
аңызақ	noun
аңызғақ	noun
аңыздандыру	verb
аңыздаушы	noun
аңызды	adj
аңыздық	adj
аңызшы	noun
аңырайту	verb
аңырайып-саңыраю	verb
аңырайысу	verb
аңырақай noun	
аңыраңдау verb	
аңырасу	verb
аңырату	verb
аңырау	verb
аңыраю	verb
аңырту	verb
аңыру	verb
аңырысу	verb
аңыс	noun
аңысқойлық	noun
аңыстау	verb
аорист	noun
ап	misc
ап-айқын	adj
ап-аласа	adj
ап-алыс	adj
ап-анық	adj
ап-арзан adj	
ап-арық	adj
ап-ауыр	adj
ап-ашық	adj
ап-ащы	adj
апа	noun
апа-жезде	noun
апа-қарындас	noun
апа-сапа	noun
апағай	noun
апажан	noun
апай	noun
апай-топай	noun
апайтөс	noun
апақ-сапақ	noun
апақ-сапақта	noun
апалақ	noun
апалақ-сапалақ	adj
апалақтасу	verb
апалақтау	verb
апалаң-топалаң	noun
апалау	verb
апалы-сіңлілі	noun
апалық	noun
апан	noun
апандай	noun
апандық	adj
апаның	noun
апап-тапап	adv
апаратын	verb
апарғызу	verb
апартеид	verb
апартқызу	verb
апарту	verb
апару	verb
апарылу	verb
апарысу	verb
апас-қапас	noun
апас-қапаста	noun
апасының	adj
апат	noun
апатай	noun
апатайлату	verb
апатайлау	verb
апатит	noun
апатия	noun
апатиялық	adj
апатсыз	adv
апаттау	verb
апатты	adj
апаттық	adj
апаттылық	noun
апеке	noun
апекс	noun
апелляция	noun
апелляциялық	adj
апелляциясыз	adj
апельсин	noun
аперитив	noun
апикальды	adj
апитерапия	noun
апиын	noun
апиынның noun	
апиыншы	noun
апқы	adj
апогей	noun
аподиктілік	noun
апокалипсис	noun
апокрин	noun
апокринді	adj
апокриф	noun
апокрифтік	adj
аполитизм	noun
аполитик	adj
аполог	noun
апологет	noun
апологетика	noun
апологеттік	adj
апология	noun
апоплексия	noun
апорт	noun
апостериори	noun
апостериорлық	adj
апостиль	noun
апостильдеу	verb
апостол	noun
апостолдық adj	
апостроф	noun
апофема	noun
апофеоз	noun
апофония	noun
аппақ	adj
аппарат	noun
аппаратура	noun
аппаратхана	noun
аппаратшы	noun
аппассионато	noun
аппендикс	noun
аппендицит	noun
апперцепция	noun
аппликатура	noun
аппликация	noun
аппретура	noun
аппроксимация	noun
апраксия	noun
априори	noun
априорлық	adj
априорлылық	adj
апробация	noun
апробациялау	verb
апроши	noun
апсағай	adj
апсағайлану	verb
апсалдай adv	
апситу	verb
апсию	verb
апта	noun
аптағыш	noun
аптал	adj
апталап	adv
апталап-айлап	adv
апталау	verb
апталғыш	noun
апталу	noun
апталық	noun
апталым	noun
апталып-күптелу	verb
аптап	noun
аптапты	adj
аптату	verb
аптау	verb
аптығу	verb
аптығысу	verb
аптық	noun
аптыққан adj	
аптықпа	adj
аптықтыру	verb
апшу	verb
апшы	noun
апшыту	verb
апы	noun
апыл	adj
апыл-ғұпыл	adv
апыл-жұпыл	noun
апыл-құпыл	adv
апыл-тапыл	adj
апыл-тұпыл	adj
апыр-ай	prep
апыр-ау	prep
апыр-жапыр	noun
апыр-топыр	noun
апырайлау	verb
апырақтау	verb
апыраң-тапыраң	adv
апыраңдату	verb
апыраңдау	verb
апырау-ау	prep
апырым-ай	prep
апырым-ау	prep
апырып-жапыру	verb
ар	noun
ар-абырой	noun
ар-иман	noun
ар-инабат	noun
ар-намыс	noun
ар-намысты	adj
ар-ождан	noun
ар-ұждан	noun
ар-ұят	noun
ар-ұятсыз	adj
ар-ұятты	adj
ар-ұяттылық	noun
ара	noun
ара-арасы	noun
ара-арасында	prep
ара-тұра	adv
араб	noun
арабалық	noun
арабеск	noun
араби	adj
арабизм	noun
арабист	noun
арабтану noun	
арабша	adj
арабшалау	verb
арабшылау	verb
арабы	adj
арагонит	noun
арагідік	adv
арада	prep
арадағы	prep
аражегіш	noun
аражік	noun
араз	noun
араз-құраз	noun
араздасқызу	verb
араздастыру	verb
араздасу	verb
араздық	noun
арай	noun
арайландыру	verb
арайлану	verb
арайлату	verb
арайлау	verb
арайлы	adj
арайлылық	adj
арайсыз	adj
аракчеевшілдік	noun
арақ	noun
арақ-шарап	noun
арақатынас	noun
арақатынастылық	adj
арақатыс	noun
арақашықтық	noun
араққор	noun
араққорлық	noun
араққұмар	noun
араққұмарлық	noun
арақоспақ	noun
арал	noun
араланған	adj
аралану	verb
аралас	adj
аралас-құралас	adj
аралас-құраластық	noun
араласқан	noun
араласқызу	verb
араласпай	adv
араласпау	verb
араласпаушылық	noun
аралассыз	adj
араласты	adj
араластырғыш	noun
араластыру	verb
араластырылу	verb
араластырып	adv
араласу	verb
араласып	adv
аралатпа	adj
аралату	verb
аралау	verb
аралаушы	noun
аралды	adj
аралдық	adj
аралша	adv
аралшық	noun
аралы	adj
аралық	noun
арам	adj
арамдалу	verb
арамданбау	verb
арамдану	verb
арамдату	verb
арамдау	verb
арамдаушы	noun
арамдық	adj
арамей	noun
арамжуа	noun
арамза	adj
арамзада	adj
арамзалану	verb
арамзалы	adj
арамзалық	noun
арамқұлақ	noun
арамниеттілік	noun
арамойлылық	adj
арампиғылдық	adj
арамсирақ	noun
арамсояу	noun
арамсыну	verb
арамтаған	noun
арамтамақ	noun
арамтамақтар	noun
арамтамақтық	noun
арамтер	noun
арамтұмсық	noun
арамшағыр	noun
арамшөп	noun
арамшырмауық	noun
арамшытыр	noun
арамызда	prep
аран	noun
арандағыш	adj
арандай	adv
арандалу	verb
арандататын	adj
арандатқыш	noun
арандату	verb
арандатушы	noun
арандатушылық	noun
арандау	verb
аранжирлау	verb
аранжирлеуші	noun
аранжирлеушілік	noun
араншы	noun
араншылық	noun
арапшы	noun
арасалмақ	noun
арасан	noun
арасат	noun
арасында	prep
арасындағы	prep
арасынша	prep
арат	noun
араукария	noun
арахана	noun
араша	adv
арашаласу	verb
арашалату	verb
арашалау	verb
арашалаушы	noun
арашаруашылық	adj
арашашы	noun
арашы	noun
арашық	noun
арба	noun
арба-арба	noun
арба-сайман	noun
арбағаш	noun
арбағыш	noun
арбайтын	adj
арбакеш	noun
арбакештік	adj
арбақ-сарбақ	adj
арбалату	verb
арбалау	verb
арбалған	adj
арбалет	noun
арбалу	verb
арбалы	adj
арбалық	adj
арбандату	verb
арбаң	noun
арбаң-арбаң	adj
арбаң-құрбаң	adj
арбаң-тарбаң	adj
арбаң-тарбаңдық	adj
арбаң-ұрбаң	adj
арбаңдату	verb
арбаңдау	verb
арбасу	verb
арбату	verb
арбау	verb
арбаушы	noun
арбаушылық	noun
арбауыш	noun
арбаша	noun
арбашы	noun
арбашық	noun
арбиған	adj
арбитр	noun
арбитраж	adj
арбитраждық	adj
арбиту	verb
арбию	verb
арболит	noun
арбыз	noun
аргенталь noun	
аргентин	noun
арго	noun
аргон	noun
аргонавт	noun
арготизм	noun
аргумент	noun
аргументтеу	verb
арғас	noun
арғы	adj
арғы-бергі prep	
арғымақ	noun
арғымақтай adv	
арда	noun
ардагер	noun
ардағым	noun
ардақ	noun
ардақталу	verb
ардақтап	adv
ардақтату	verb
ардақтау	verb
ардақтаушы	noun
ардақты	adj
ардақтылық	noun
ардометр	noun
ардың-күрдің	adj
ареал	noun
ареалдық adj	
арена	noun
ареналық adj	
аренда	noun
арендалау	verb
арендалық	adj
арендатор	noun
ареология	noun
ареометр	noun
арестант	adj
арестанттық	adj
аржайы	adj
аржайыландыру	verb
аржайылану	verb
аржайылық	noun
аржақ	noun
аржақ-бержақ	noun
аржақтағы	noun
аржантин	noun
арзан	adj
арзандаған	adj
арзандату	verb
арзандатылған	adj
арзандатылу	verb
арзандау	verb
арзанды-қымбатты adj	
арзандық	noun
арзандылық	noun
арзанқол	noun
арзанқолды	adj
арзансу	verb
арзаншылық	noun
арзу	verb
ариетта	noun
арийлық	adj
арийлік	adj
ариозо	noun
аристократ	noun
аристократизм	noun
аристократия	noun
аристократтық	adj
аристофан	noun
аритмия	noun
аритмиялық	adj
арифметика	noun
арифметикалық	adj
арифмограф	noun
арифмометр	noun
ария	noun
арияйдай adv	
арка	noun
аркада	noun
арктика	adj
арктикалық	adj
арқа	noun
арқа-басы	noun
арқа-жарқа	noun
арқа-жеңі	noun
арқадағы	noun
арқал	noun
арқалайтын	adj
арқалану	verb
арқаласу	verb
арқалату	verb
арқалау	verb
арқалы	adj
арқалық	noun
арқамшы	adj
арқан	noun
арқан-жіп	noun
арқанаттау	verb
арқандалу	verb
арқандату	verb
арқандау	verb
арқандаулы	adj
арқансауыт	noun
арқантартпақ	noun
арқанша	adv
арқаншы	noun
арқар	noun
арқар-меринос	noun
арқарбұйырғын	noun
арқаржалақ	noun
арқаржапақ	noun
арқаржусан	noun
арқармүйіз	noun
арқасыз	adj
арқасыздық	noun
арқасында	prep
арқатұтушылық	noun
арқау	noun
арқау-желі	noun
арқау-өзек	noun
арқаулау	verb
арқаулы	adj
арқаулық	adj
арқаусыз	adj
арқаушыбық	noun
арқылы	prep
арқын-жарқын	adj
арқырасу	verb
арқырату	verb
арқырау	verb
арқырауық	noun
арлан	noun
арланбастан	adv
арланбау	verb
арланғыш	adj
арланғыштық	noun
арландай	adv
арландыру	verb
арлану	verb
арлау	verb
арлекин	noun
арлы	adj
арлылық	noun
арма	noun
армада	noun
арман	noun
арман-бермен	adj
арман-қиял	noun
арман-мақсат	noun
арман-тілек	noun
арманда	noun
армандас	noun
армандату	verb
армандау	verb
арманды	adj
армансыз	adj
армансыздық	noun
арманшыл	noun
арманшылдық	noun
армата	noun
арматура	noun
арматуралық	adj
арматурашы	noun
армия	noun
армиялық	adj
армрестлинг noun	
армян	noun
арна	noun
арнай	adj
арнайы	adj
арналас	adj
арналау	verb
арналған adj	
арналу	verb
арналы	adj
арналық	adj
арнап	adv
арнасу	verb
арнасыз	adj
арнату	verb
арнау	verb
арнаулы	adj
арнаухат	noun
арника	noun
арп	noun
арпа	noun
арпа-бидай	noun
арпабас	noun
арпабоз	noun
арпаған	adj
арпакөже noun	
арпалау	verb
арпалыс	noun
арпалысқызу	verb
арпалыстыру	verb
арпалысу	verb
арпаң-тарпаң	adj
арпасу	verb
арпаталқан adj	
арпашөп	noun
арпыл	adj
арпыл-тарпыл	adj
арпылдасу	verb
арпылдату	verb
арпылдау	verb
арс	noun
арс-арс	noun
арс-ұрс	noun
арса	noun
арса-арса	adv
арсақай	adj
арсалақтау	verb
арсалану	verb
арсалаң	adj
арсалаңдау	verb
арсаң	adj
арсаңдау	verb
арсенал	noun
арсиған	adj
арсию	verb
арсы-күрсі	adj
арсыз	adj
арсыздандыру	verb
арсыздану	verb
арсызданушылық	noun
арсызданып	adv
арсыздау	adj
арсыздық	noun
арсыл	noun
арсыл-күрсіл	noun
арсылдақ	noun
арсылдасу	verb
арсылдату	verb
арсылдау	verb
арсынбай	adv
арсыну	verb
арт	noun
артезиан adj	
артель	noun
артельдестіру	verb
артельдесу	verb
артельдік	adj
артельші	noun
артериола	noun
артериосклероз	noun
артерия	noun
артериялық	adj
артикль	noun
артикул	noun
артикуляция	noun
артикуляциялау	verb
артикуляциялық	adj
артиллерист	noun
артиллерия	noun
артиллериялық	adj
артиллерияшы	noun
артист	noun
артистік	adj
артистікпен	noun
артисше	adv
артқа	adv
артқан	adj
артқы	adj
артқызу	verb
артпа	adj
артпалы	adj
артрит	noun
артроз	noun
артта	prep
арттағы	adj
арттақалушылық	noun
арттан	prep
арттырмау	verb
арттыру	verb
арттырылған	adj
арттырылу	verb
арту	verb
арту-арту	adj
арту-тарту	verb
артушы	noun
арты	noun
артығы	noun
артығымен noun	
артық	adj
артық-ауыс noun	
артық-бұртық	adj
артық-кем	adj
артық-кемді	pron
артық-кемдік	noun
артықкетушілік	noun
артықсынбау	verb
артықсыну	verb
артықтау	noun
артықтық	noun
артықтылық	noun
артықша	adj
артықшылығы	noun
артықшылық	noun
артықшылықты	adj
артылған	adj
артылдыру	verb
артылу	verb
артылыс	noun
артымен adv
артынан	adv
артында	prep
артыну	verb
артынша	prep
артынып-тартыну	verb
артып-тарту	verb
артысу	verb
ару	verb
аруақ	noun
аруақсыз adj	
аруақтай adv	
аруақтанбау	verb
аруақтану	verb
аруақтау	verb
аруақты	adj
аруақшыл adj	
аруана	noun
аруанадай noun	
аруз	noun
арулау	verb
арулық	noun
арфа	noun
арфашы	noun
архаизм	noun
архей	noun
археография	noun
археографиялық	adj
археолог	noun
археология	noun
археологиялық	adj
архив	adj
архивариус	
архивтік	adj
архившы	noun
архивші	noun
архиепископ	noun
архиерей	noun
архимандрит	noun
архипелаг	noun
архитектоника	noun
архитектор	noun
архитектура	noun
архитектуралық	adj
архифонема	noun
арша	noun
аршагүл	noun
аршадай	noun
аршалы	adj
аршалық	adj
аршашыл	adj
аршу	verb
аршулы	adj
аршушы	noun
аршығыш	noun
аршыл	adj
аршылған	adj
аршылмаған	adj
аршылу	verb
аршыма	noun
аршын	noun
аршынбар noun	
аршындай adv	
аршындату	verb
аршындау	verb
аршынды	adj
аршысу	verb
аршыту	verb
ары	adv
ары-бері pron	
арыған	noun
арыз	noun
арыздану	verb
арызданушы	noun
арыздастыру	verb
арыздасу	verb
арызкеш	noun
арызқағаз	noun
арызқой	noun
арызқойлық	noun
арызқор	noun
арызқұмар	noun
арызқұмарлық	noun
арызшы	noun
арызшыл	noun
арық	noun
арық-арна	noun
арық-атыз	noun
арық-жап	noun
арық-тұрақ	noun
арық-тұрық	noun
арықжалбыз	noun
арықсыну	verb
арықтату	verb
арықтау	verb
арықтұра	adj
арықтық	noun
арықша	adj
арыл	noun
арылдап-гүрілдеу	verb
арылдасып-шарылдасу	verb
арылдату	verb
арылдау	verb
арылдауық	adj
арылдыру	verb
арылмаған	adj
арылту	verb
арылу	verb
арымай-талмай	adv
арымайтын	adj
арын	noun
арындату	verb
арындау	verb
арындауық	adj
арынды	adj
арындылық	noun
арынсыз	adv
арыншыл	adj
арып-ашу	verb
арып-ашыған	adj
арып-талу	verb
арыпталу	verb
арыс	noun
Арыс	noun
арыстай	adj
арыстан	noun
Арыстан	noun
арыстандай	noun
арыстанқұйрық	noun
арыстанша	adv
арыту	verb
арыш	noun
арьергард	noun
арьергардтық	adj
ас	noun
ас-ауқат noun	
ас-дәм	noun
ас-су	noun
ас-тағам	noun
ас-шай	noun
аса	noun
асаба	noun
асабият	noun
асадал	noun
асай-мұса	noun
асай-мұсай	noun
асай-мүсей	noun
асаймұса	noun
асалы	adj
асам	noun
асанқайғы	adj
Асанқайғы	noun
асанқайғылану	verb
асанқайғылық	noun
асар	noun
асар-аспас	
асарлату	verb
асарлау	verb
асархана	noun
асаршы	noun
асатаяқ	noun
асатқызу	verb
асаттыру	verb
асату	verb
асау	verb
асау-албырт	adj
асаудай	adv
асаукөк	noun
асауланбау	verb
асаулану	verb
асаулық	noun
асаусу	verb
асаусыну verb	
асауыш	noun
асбасшы	noun
асбест	noun
асбестік	adj
асболит	noun
асбұзыл	noun
асбұршақ	noun
асейсмикалық	adj
асептика	noun
асептикалық	adj
асжаулық	noun
асимметрия	noun
асимметриялық	adj
асинергия	noun
асинхронды	adj
аскания	noun
асканиялық	adj
аскарида	noun
аскет	noun
аскетизм	noun
аскеттік	adj
аския	noun
аскорбин noun	
аскөк	noun
асқабақ	noun
асқабақтай	adv
асқазан	noun
асқақ	adj
асқақтаған	adj
асқақтану	verb
асқақтап	verb
асқақтату	verb
асқақтау	verb
асқақтаушылық	noun
асқақтық	noun
асқақтылық	noun
асқақшыл adj	
асқан	adj
асқандық adj	
асқар	adj
асқаралы	adj
асқардай	adv
асқасық	noun
асқатық	noun
асқатықтық	noun
асқорытқыш	noun
асқорыту	noun
асқызу	verb
асқын	prep
асқынған	adj
асқындату	verb
асқындау	verb
асқындырғыш	adj
асқындыру	verb
асқындырушы	noun
асқынөткізгіштік	noun
асқынту	verb
асқыну	verb
асқынушылық	noun
асқысыз	adj
асқыш	adj
асмалдық	noun
аспа	noun
аспа-жалап	adj
аспабесік	noun
аспаз	noun
аспаздық	noun
аспазхана	noun
аспазшы	noun
аспазшылық	noun
аспай-саспай	adj
аспакөпір	adj
аспалы	adj
аспан	noun
аспан-көк	adj
аспанға	noun
аспандағы	adj
аспандай	noun
аспандап	adv
аспандату	verb
аспандау	verb
аспанкез	noun
аспанкөк	noun
аспансерік	noun
аспап	noun
аспаптандыру	verb
аспаптану	verb
аспаптау	verb
аспапты	adj
аспаптық	adj
аспапшы	noun
аспара	noun
аспау	noun
аспашам	noun
аспект	noun
аспектолог	noun
аспектология	noun
аспид	noun
аспирант	noun
аспиранттық	
аспирантура	noun
аспиратор	adj
аспирация	noun
аспирин	noun
аспісірім	noun
ассалаумағалайкүм	noun
ассалаумаликум	noun
ассамблея	noun
ассемблер	noun
ассенизатор	noun
ассигнация	noun
ассигнациялау	verb
ассигновка	noun
ассиметрия	noun
ассимиляторлық	adj
ассимиляция	noun
ассимиляцияланған	adj
ассимиляциялану	verb
ассимиляциялау	verb
ассимиляциялық	adj
ассириялық	adj
ассистент	noun
ассистенттік	adj
ассонанс	noun
ассорти	noun
ассортимент	noun
ассоциативтік	adj
ассоциативтілік	adj
ассоциация	noun
ассоциациялану	verb
ассоциациялық	adj
ассүттіген	noun
аста-төк	adj
астағы	noun
астағыпыралла	noun
астазия	noun
астам	adj
астамдық	noun
астамсу	verb
астамсыту	verb
астамшыл	adj
астамшылық	noun
астан-кестен	noun
астана	noun
астаналы	adj
астаналық	adj
астапыралла	noun
астар	noun
астарқабат	
астарлану	verb
астарлап	adv
астарлас	adj
астарласу	verb
астарлату	verb
астарлау	verb
астарлы	adj
астарлық	adj
астарлылық	adj
астарсыз	adj
астас	noun
астастыру	verb
астасу	verb
астатым	noun
астау	noun
астаубас	noun
астаулау	verb
астауша	noun
астаушық	adj
астаһари	noun
астеник	noun
астения	noun
астерия	noun
астероид	noun
астигматизм	noun
астра	noun
астробиология	noun
астроботаника	noun
астрогеография	noun
астрогеология	noun
астрограф	noun
астролог	noun
астрология	noun
астролябия	noun
астронавт	noun
астронавтика	noun
астроном	noun
астрономия	noun
астрономиялық	adj
астрофизик	noun
астрофизика	noun
астрофизикалық	adj
астрофотография	noun
астрофотометр	noun
астрохимия	noun
асты	noun
асты-үсті	noun
асты-үстілі	adj
астық	noun
астықағаш	noun
астықжақсартқыш	noun
астықкептіргіш	noun
астықсыз	adj
астықтасығыш	noun
астықтиеуіш	noun
астықты	adj
астықхана	noun
астылы-үстілі	adj
астымен	noun
астын-үстін	noun
астына	adv
астынан	prep
астында	prep
астындағы	prep
астыңғы	adj
астырт	adv
астыртын	adv
астыру	verb
асу	verb
асу-асу	adj
асулы	adj
асулық	noun
асусыз	adj
асүй	noun
асүйлік	adj
асфальт	noun
асфальтобетон	noun
асфальтсыз	adj
асфальтталған	adj
асфальтталу	verb
асфальттану	verb
асфальттату	verb
асфальттау	verb
асфальтты	adj
асфальттық	adj
асфаһанды	adj
асфаһани	noun
асфиксия	noun
асхана	noun
асхана-фабрика	noun
асханалық	adj
асхананың	noun
асханашы	noun
асцит	noun
асшаян	noun
асшы	noun
асы	adj
асығу	verb
асығушы	noun
асығушылық	noun
асығымпаз	adj
асығып-аптығып	verb
асығып-үсігу	verb
асығып-үсігіп	adv
асығыс	adj
асығыс-үсігіс	adj
асығыста	adv
асығыстық	noun
асық	noun
асық-топай	noun
асықжілік	noun
асыққансу	verb
асыққыш	adj
асықпай	adv
асықпай-аптықпай	adv
асықпай-саспай	adv
асықпастан	adv
асықпау	verb
асықпаушылық	noun
асықтай	adj
асықты	verb
асықтырмау	verb
асықтыру	verb
асықша	adv
асыл	adj
асылатын	noun
асылған	adj
асылдандырғыш	adj
асылдандыру	verb
асылдану	verb
асылдық	noun
асылдыру	verb
асылзада	noun
асылма	noun
асылту	verb
асылтұқым	noun
асылтұқымды	adj
асылу	verb
асылы	noun
асылық	noun
асылында	noun
асылыну	verb
асым	noun
асынған	adj
асындыру	verb
асыну	verb
асып-сасу	verb
асып-сасушылық	noun
асып-сасып	adv
асып-тасу	verb
асып-тасушылық	noun
асыр	noun
асыр-насыр	noun
асыр-сауық	noun
асыр-тасыр	noun
асыр-тұсыр	noun
асыра	noun
асыралу	verb
асыралыну	verb
асыранды	adj
асырап-сақтаушы	noun
асырасу	verb
асырасілтеушілік	noun
асырату	verb
асырау	verb
асыраулы	adj
асыраусыз	adj
асыраушы	noun
асырғандық	noun
асырма	adj
асырмалы	adj
асыртпау	verb
асырту	verb
асыру	verb
асырылған	adj
асырылу	verb
асырым	noun
асысу	verb
ат	noun
ат-айғырлар	noun
ат-анжам	noun
ат-арба	noun
ат-атақ	noun
ат-жабдық	noun
ат-жарақ	noun
ат-көлік	noun
ат-күші	noun
ат-сайман	noun
ат-тон	noun
ат-топыр	noun
ат-тұрман	noun
ат-түйедей	adv
ат-шана	noun
ат-шапан	noun
ата	noun
ата-ана	noun
ата-анадай	noun
ата-аналар	noun
ата-аналық	noun
ата-баба	noun
ата-бабалар	noun
ата-бабалық	adj
ата-ене	noun
ата-енелік	adj
ата-мекен	noun
ата-мұра	
ата-тек	noun
атабек	noun
атавизм	noun
атавистік	adj
атағат	noun
атағаш	noun
атажау	noun
атажұрт	noun
атазаң	noun
атазу	verb
атай	noun
атайман	adj
атайы	adj
атакәсіп	noun
атакеш	noun
атаксия	noun
атақ	noun
атақ-абырой	noun
атақ-даңқ	noun
атақ-дәреже	noun
атаққұмар	adj
атаққұмарлық	noun
атақоныс	noun
атақсыз	adj
атақсыздық	noun
атақтану	verb
атақты	adj
атақтылық	noun
атақшыл	adj
атақшылық	noun
атал-сатал	adj
атала	noun
аталадай	
аталақтату	verb
аталақтау	verb
аталас	noun
аталастық	noun
аталатын	adj
аталау	verb
аталған	adj
аталғы	adj
аталмыш	adj
аталу	verb
аталы	adj
аталы-балалы	adj
аталық	adj
аталықсыздандыру	verb
аталым	noun
аталыну	verb
атамалы	adj
атаман	noun
атамандық	adj
атамекен	noun
атамзаман	adj
атамзаманда	noun
атамұра	noun
атан	noun
атанғызу	verb
атандай	noun
атандық	adj
атандыру	verb
атанжарыс	noun
атантұяқ	noun
атану	verb
атанша	adv
атаны	noun
атарман	noun
атарман-шабарман	noun
атастыру	verb
атастырылу	verb
атасу	verb
атасы	noun
ататегі	noun
ататек	noun
ататқызу	verb
ататтыру	verb
атату	verb
ататіл	noun
атау	verb
атау-кере	noun
атаукомитет	noun
атауланған	adj
атаулы	adj
атаулық	noun
атаунама	noun
атаусөз	noun
атаусыз	adj
атаушы	noun
атауыз	noun
атауыш	noun
аташ	noun
атәбзел	noun
атбағар	noun
атбайлар	noun
атбайлауыш	noun
атбалық	noun
атбас	noun
атбасбұршақ	noun
атбәйге	noun
атбегі	noun
атбегілік	adj
атбесік	noun
атбұршақ	noun
атдорба	noun
атеизм	noun
атеист	noun
атеистік	adj
атеке	noun
ателье	noun
атеросклероз	noun
атерін	noun
атерінді	adj
атжабу	verb
атжақты	adj
атжал	noun
атжалдану	verb
атжалдату	verb
атжалдау	verb
атжалман	noun
атжап	noun
атжарыс	noun
атжәмші	noun
атжетер	noun
атжуа	noun
атжүргіш	noun
атипия	noun
атком	noun
аткөпшік	noun
аткөпір	noun
аткөрпе	noun
атқағар	noun
атқазық	noun
атқамінер	noun
атқамінерлік	noun
атқарарлық	adj
атқарту	verb
атқару	verb
атқару-басқару	verb
атқарушы	noun
атқарушылық	adj
атқарылған	adj
атқарылу	verb
атқарым	noun
атқарысу	verb
атқонақ	noun
атқора	noun
атқосшы	noun
атқосшылы	adj
атқосшылық	noun
атқу	verb
атқұйрықтар	noun
атқұлақ	noun
атқұлақтану	verb
атқұмар	noun
атқұмарлық	noun
атқызу	verb
атқыласу	verb
атқылату	verb
атқылау	verb
атқыр	adj
атқыту	verb
атқыш	noun
атқыштар	adj
атқыштық	adj
атқышыл	adj
атлант	adj
атлас	noun
атлет	noun
атлетизм	noun
атлетика	noun
атлетикалық	adj
атлетші	noun
атмайы	noun
атмалтыс	noun
атмометр	noun
атмосфера	noun
атмосфералық	adj
атой	noun
атойласу	verb
атойлату	verb
атойлау	verb
атолл	noun
атом	noun
атом-молекулалық adj	
атомгер	noun
атомды	adj
атомдық	adj
атомизатор	
атомизм	noun
атомистика	noun
атомистік	adj
атомкеме	noun
атомсағат	noun
атомсыз	adj
атомшы	noun
атомшыл	adj
атомырауластыру	verb
атпа	noun
атпаз	noun
атпазығыр	noun
атпай-шаппай	adj
атпақияр	noun
атпақыл	adj
атпал	adj
атпалау	verb
атпалдай	adv
атпатамыр	noun
атпатамырлы	adj
атрезия	noun
атрибут	noun
атрибуттық	adj
атропин	noun
АТС	noun
атсайман	noun
атсайыс	noun
атсалысу	verb
атсалысушылық	noun
атсауыт	noun
атсейіс	noun
атсоқты	noun
атсыз	adj
атсыздану	verb
атсыншы	noun
атсілеусін	noun
аттай	adj
аттам	noun
аттамалы	adj
аттан	noun
аттандасу	verb
аттандату	verb
аттандау	verb
аттандыру	verb
аттандырушы	noun
аттану	verb
аттаныс	noun
аттанысу	verb
аттап	adv
аттарақ	noun
аттас	noun
аттастық	verb
аттасу	verb
аттатқызу	verb
аттату	verb
аттау	verb
атташе	noun
атташелік	adj
аттергеу	verb
аттерші	noun
аттеріс	noun
аттестат	noun
аттестаттау	verb
аттестатты	adj
аттестация	noun
аттестациялау	verb
аттестациялық	adj
аттракцион	noun
аттракциондық	adj
аттракция	noun
атты	adj
аттық	adj
аттылы	noun
аттылы-жаяу	adj
аттылы-жаяулы	adj
аттырма	noun
аттырма-оқ	noun
аттыру	verb
ату	verb
ату-стенд	noun
атұстар	noun
атүсті	adv
атүстілік	adj
атша	adv
атшабар	noun
атшабыс	noun
атшалман	noun
атшаптырым	noun
атшоңқай	noun
атшу	noun
атшы	noun
аты	noun
аты-жөні	noun
атығу	verb
атыз	noun
атыз-арық	noun
атыз-жап	noun
атыздай	adv
атыздалу	verb
атыздату	verb
атыздау	verb
атызды	adj
атылған	adj
атылу	verb
атылыс	noun
атым	noun
атымен	adv
атындағы	noun
атынды	noun
атыңқырау	
атырап	noun
атырау	noun
атыру	adj
атыс	noun
атыс-шабыс	noun
атыспақ	noun
атыстыру	verb
атысу	verb
атышулы	adj
ау	noun
ау-аулау	verb
ау-жылым	noun
ау-хау-хау	int
ауа	noun
ауадай	noun
ауажайылушылық	noun
ауаза	noun
ауаиіс	noun
ауаландыру	verb
ауалану	verb
ауалы	adj
ауам	adj
ауамдық	noun
ауан	noun
ауандау	verb
ауандық	noun
ауани	adj
ауаөткел	noun
ауаөткізгіш	noun
ауасуытқыш	noun
ауасүзгі	noun
ауасыз	adj
ауатазартқыш	noun
ауатамыр	noun
ауатком	noun
ауаүрлегіш	noun
аугер	noun
ауған	noun
ауғани	adj
Ауғанстан	noun
ауғаншылар	noun
ауғыздыру	verb
ауғызу	verb
ауғын	noun
ауғыш	adj
аудан	noun
ауданаралық	adj
аудандастыру	verb
аудандастырылу	verb
аудандау	verb
ауданды	adj
аудандық	adj
аударғыш	noun
аударма	noun
аудармай	adv
аудармалау	verb
аудармалы	adj
аудармалық	adj
аудармашы	noun
аудармашылық	adj
аударту	verb
аудару	verb
аударушы	noun
аударылған	adj
аударылмайтын	adj
аударылмалы	adj
аударылу	verb
аударылып-төңкерілу	verb
аударым	noun
аударып-төңкеру	verb
аударып-төңкерістіру	verb
аударыс	noun
аударыспақ	noun
аударыстыру	verb
аударысу	verb
аудиенция	noun
аудиокассета	noun
аудиомәлімдеме	noun
аудиометр	noun
аудиотаспа	noun
аудит	noun
аудитор	noun
аудитория	noun
аудиторлық	adj
аудыру	verb
аужай	noun
аужайлас	noun
аужайлау	verb
аужал	noun
аужар	adj
аужарлық	noun
аузы	noun
аузы-аузына	noun
аузы-басы	noun
аузы-мұрны	noun
аукцион	noun
аукциондық	adj
аукционер	noun
аукционшы	noun
ауқат	noun
ауқат-сауқат	noun
ауқатсыз	adj
ауқаттандыру	verb
ауқаттану	verb
ауқатты	adj
ауқаттылық	noun
ауқым	noun
ауқым-ауқым	adv
ауқымдану	verb
ауқымдасқызу	verb
ауқымдастыру	verb
ауқымдасу	verb
ауқымдау	verb
ауқымды	adj
ауқымдық	adj
ауқымдылық	noun
аула	noun
аулағыш	noun
аулақ	adv
аулақта	adv
аулақтанбау	verb
аулақтанған	adj
аулақтандыру	verb
аулақтандырылу	verb
аулақтану	verb
аулақтату	verb
аулақтатылу	verb
аулақтау	verb
аулалас	adj
аулалық	adj
аулану	verb
ауласу	verb
аулату	verb
аулау	verb
аулаушы	noun
аума	adj
аума-төкпе	adj
аумаған	adv
аумай	adv
аумайтын	adj
аумақ	noun
аумақсыз	adj
аумақтандыру	verb
аумақтану	verb
аумақтау	verb
аумақты	adj
аумақтық	adj
аумақтық-өндірістік	adj
аумақтық-шаруашылық	adj
аумалы	adj
аумалы-төкпелі	adj
аумалылық	noun
аумау	verb
аумашыл	adj
аумин	noun
аумыс	noun
аунақ	noun
аунақтау	verb
аунақшу	verb
аунақшып-дөңбекшу	verb
аунақшыту	verb
аунап-қунау	verb
аунату	verb
аунатылатын	adj
аунатылған	adj
аунатылу	verb
аунау	verb
аура	noun
ауру	noun
ауру-адам	noun
ауру-сауы	noun
ауру-сырқат	noun
ауру-сырқау	noun
ауру-сырқаулы	adj
ауру-сырқаулық	noun
ауру-індет	noun
ауруқоздырғыш	adj
ауруқоздырғыштар noun	
аурулау	adj
аурулы	adj
аурулы-сырқаулы	adj
аурулық	noun
аурусыз	adj
аурусыздық	noun
аурутуғызғыш	noun
аурухана	noun
ауруханалық	adj
ауруханаішілік	adj
аурушаң	adj
аурушаңдық	adj
аусар	adj
аусарлану	verb
аусарлық	noun
аустраль	noun
аусыл	adj
аут	noun
аутогенді	adj
аутодафе	noun
аутоқуыш	noun
аутсайд	noun
аутсайдер	noun
ауу	verb
аухал	noun
аухау	noun
аухаулау	verb
аушадияр	noun
аушы	noun
аушылық	noun
ауыз	noun
ауызашар	noun
ауызашарлық	adj
ауызаяқтылар	noun
ауызба-ауыз	noun
ауызбаққыш	noun
ауызбаққыштық	adj
ауызбастырық	noun
ауызбау	verb
ауызбен	adj
ауызби	noun
ауызбірлік	noun
ауызбірлікті	adj
ауызғы	adj
ауыздақтау	verb
ауыздан-ауызға	noun
ауызданбау	verb
ауыздандыру	verb
ауыздандырушы	noun
ауыздану	verb
ауызды	adj
ауыздық	noun
ауыздықсыз	adj
ауыздықталған	adj
ауыздықталу	verb
ауыздықтату	verb
ауыздықтау	verb
ауыздықтаулы	adj
ауыздықты	adj
ауызекі	adj
ауызжаппас	noun
ауызжолды	adj
ауызқобыз	noun
ауызомыртқа	nounounn
ауызот	noun
ауызсу	noun
ауызсулық	noun
ауызсырнай	noun
ауызтамыр	noun
ауызтатырлық	noun
ауызтұшырлық	noun
ауызүй	noun
ауызша	adj
ауық	adv
ауық-ауық	adv
ауыл	noun
ауыл-аймақ	noun
ауыл-ауыл	noun
ауыл-село	noun
ауыл-үй	noun
ауылағасы	noun
ауыларалық	adj
ауылбасы	noun
ауылдас	noun
ауылдастық	adj
ауылды	adj
ауылдық	adj
ауылжақтық	noun
ауылнай	noun
ауылнайлық	noun
ауылүй	noun
ауылша	adv
ауылшаруашылық	adj
ауылшарушылық	adj
ауылшылау	verb
ауылшылдық	noun
ауым-сауым	adj
ауын	noun
ауыңқы	adj
ауыр	adj
ауыр-ауыр	adj
ауыр-жеңіл	adj
ауырғыш	adj
ауырдәулетті	adj
ауырлаған	adj
ауырланбау	verb
ауырлану	verb
ауырлататын	adj
ауырлаттыру	verb
ауырлату	verb
ауырлау	verb
ауырлауы	noun
ауырлық	noun
ауырмағандай	adv
ауырмай-сырқамай	adv
ауырмалдық	noun
ауырмау	verb
ауырсындырмау	verb
ауырсыну	verb
ауырта	adv
ауыртатын	adj
ауыртаяқ	noun
ауыртқызбаушылық	noun
ауыртқыздырмау	verb
ауыртпай	adj
ауыртпайтын	adj
ауыртпақ	
ауыртпалық	noun
ауыртпалықсыз	adj
ауыртпалықты	noun
ауыртпау	noun
ауыртпаушылық	noun
ауырттырмау	verb
ауырту	verb
ауыру	verb
ауырыңқырау	verb
ауыс	noun
ауыс-түйіс	noun
ауысқан	adj
ауыспай	adv
ауыспайтын	adj
ауыспалы	adj
ауыспалылық	noun
ауыспас	adj
ауыспастан	adv
ауыспаушылық	noun
ауыстыратын	adj
ауыстырғыш	noun
ауыстырмалы	adj
ауыстырту	verb
ауыстыру	verb
ауыстырушы	noun
ауыстырушылық	noun
ауыстырылатын	adj
ауыстырылған	adj
ауыстырылу	verb
ауыстырылымдылық	noun
ауыстырып-қосқыш	noun
ауысу	verb
ауысым	noun
ауысымалды	adj
ауысымды	adj
ауысымдық	noun
ауысымдылық	noun
ауысып	adv
ауыт	noun
ауытқу	verb
ауытқулық	noun
ауытқушы	noun
ауытқушылық	noun
ауытқығыш	adj
ауытқыма	noun
ауытқымайтын	adj
ауытқымалы	adj
ауытқымалық	adj
ауытқымаушылық	noun
ауытқыту	verb
ауытқыш	noun
ауыттау	verb
ауыттыру	verb
афазия	noun
афиша	noun
афониялық	adj
афоризм	noun
афоризмдік	adj
африка	adj
африкалық	adj
африкандық	noun
афронт	noun
аффект	noun
аффективтік	adj
аффектілеу	verb
афференттік	adj
аффикс	noun
аффикстегі	noun
аффинаж	noun
аффинаждау	verb
аффрикат	noun
ах	misc
аха-ха	misc
аха-халау	verb
аха-хау	misc
аха-хаулау	verb
АХАЖ	noun
АХАТ	noun
ахау	noun
ахком	noun
ахлақ	noun
ахлақсыздық	noun
ахромат	noun
ахроматизм	noun
ахроматикалық	adj
ахроматопсия	noun
ахуал	noun
ахуалат	noun
ахун	noun
аһ	misc
аһлау	verb
аһылап-уһілеу	verb
аһылап-үһілеу	verb
аһылау	verb
ацетилен noun	
ацетон	noun
ацетонды adj	
ацидоз	noun
ацидофил 	noun
ацидофилді	adj
ацидофилин	noun
ацтек	noun
ацтектер	noun
аш	adj
аш-арық	adj
аш-жалаңаш	adj
аш-жалаңаштық	noun
аш-тоқ	adj
аша	noun
ашабүйір noun	
ашаланбау verb
ашалану	verb
ашалаң	noun
ашалау	verb
ашалы	adj
ашалық	noun
ашамай	verb
ашамайлану	verb
ашамайлату	verb
ашамайлау	verb
ашамайлы	adj
ашамайлық	noun
ашамұрт	noun
ашамүйізділер	noun
ашаң	adj
ашаңданбау	verb
ашаңдану	verb
ашаңдау	adj
ашаңдық	noun
ашар	noun
ашаршылық	noun
ашарық	noun
ашатұяқ	noun
ашатұяқты adj	
ашатұяқтылар	noun
ашауыз	noun
ашбаспақ noun	
ашбүйір	noun
ашкөз	adj
ашкөздену	verb
ашкөздік noun	
ашкөзділік	noun
ашкүзендей	adv
ашқарақ	adj
ашқарақтану	verb
ашқарақтық	noun
ашқарын	noun
ашқарынға	noun
ашқарында	noun
ашқызу	verb
ашқыл	adj
ашқылтым	adj
ашқылтымдану	verb
ашқылтымдық	noun
ашқыш	noun
ашналықпен	adv
ашпа	verb
ашпа-жалап	adj
ашпалы	adj
ашпалы-жаппалы	
ашпасәліп	adj
аштатын	adj
ашты	adj
ашты-тоқты	adj
аштық	noun
аштырту	verb
аштыру	verb
ашу	verb
ашу-араз	adj
ашу-араздық	noun
ашу-аяң	noun
ашу-реніш	noun
ашу-ыза	noun
ашуат	noun
ашуатшөп	noun
ашуг	noun
ашудас	noun
ашудастау	verb
ашукернеген	adj
ашуқор	adj
ашуланбайтын	adj
ашуланған	adj
ашуланғандық	noun
ашуланғызу	verb
ашуланғыш	adj
ашуландыру	verb
ашулану	verb
ашуланшақ	adj
ашуланшақтық	noun
ашуланысу	verb
ашулы	adj
ашулылық	noun
ашумен	adv
ашусыз	adj
ашушаң	adj
ашушаңдық	noun
ашушы	noun
ашыған	adj
ашығу	verb
ашығыш	noun
ашық	adj
ашық-жарқын	adj
ашық-жарық	adj
ашық-тесік	adj
ашық-шашық	adv
ашықауыз	noun
ашықауыздану	verb
ашықауыздық	noun
ашыққан	noun
ашықтан-ашық	adj
ашықтық	noun
ашықтырту	verb
ашықтыру	verb
ашықхат	noun
ашылауыт	noun
ашылған	adj
ашылмаған	adj
ашылмалы	adj
ашылмалы-жабылмалы	adj
ашылу	verb
ашылулар	noun
ашылым	noun
ашылыңқыраған	adj
ашылыңқырау	verb
ашылып-жабылу	verb
ашылып-шашылу	verb
ашылыс	noun
ашымақ	noun
ашымал noun
ашына	noun
ашына-жай	noun
ашына-жайлық	noun
ашыналасу	verb
ашыналық	noun
ашынған adj
ашындыру	verb
ашынту	verb
ашыну	verb
ашынушылық	noun
ашыңқы	adj
ашыңқырау	verb
ашып-жабу	verb
ашып-жарып	adv
ашып-жұмғанша	adv
ашып-жұму	verb
ашып-шашу	verb
ашыр	verb
ашырқандыру	verb
ашырқанту	verb
ашырқану	verb
ашырлық	noun
ашысу	verb
ашытатын adj	
ашытқан	adj
ашытқы	noun
ашытқылану	verb
ашытқылау	verb
ашытқылық	noun
ашытқыш	noun
ашытпа	verb
ашыту	verb
ашытылған	adj
ашытылмаған	adj
ашытылу	verb
ашішек	noun
ащы	adj
ащы-тұщы	adj
ащыландыру	verb
ащылату	verb
ащылау	verb
ащылауыт noun	
ащылы-тұщылы	adj
ащылық	noun
ащыот	noun
ащысыну	verb
ащытамыр	noun
аэрарии	noun
аэроәдіс	noun
аэроб	noun
аэробика	noun
аэробты	adj
аэробтық	adj
аэробус	noun
аэроген	noun
аэрогенді	adj
аэрогеология	noun
аэрогеологиялық	adj
аэрограф	noun
аэрография	noun
аэроғарыш	noun
аэроғарыштық	adj
аэродинамика	noun
аэродинамикалық	adj
аэродром	noun
аэрозоль	noun
аэрозольдық	adj
аэроклуб	noun
аэроқұрылыс	noun
аэролит	noun
аэролифт	noun
аэролог	noun
аэрология	noun
аэрологиялық	adj
аэромагнит	noun
аэромагниттік	adj
аэромектеп noun	
аэрометр	noun
аэрометрия	noun
аэрометриялық	adj
аэромеханика	noun
аэромобиль	noun
аэромотор noun	
аэрон	noun
аэронавигация	noun
аэронавигациялық	adj
аэронавт noun	
аэронавтика	noun
аэроплан	noun
аэропланшет	noun
аэропочта	noun
аэропошта	noun
аэросебу	verb
аэростат	noun
аэростатика	noun
аэросурет	noun
аэросүзгі	noun
аэротаксация	noun
аэротермометр	noun
аэротозаңдандырғыш	adj
аэрофлот	noun
аэрофон	noun
аэрофотометрия	noun
аэрофотосурет	noun
аэрофототүсіру	noun
аэрошамшырақ	noun
аэрошана	noun
аю	noun
аюбадам	noun
аюбалдырған noun	
аюдай	adj
аюдам	noun
аюдың	adj
аюжаңғақ noun	
аюжидек	noun
аюжүн	noun
аюқурай	noun
аюқұлақ	noun
аюоты	noun
аютабан	noun
ая	noun
аябоз	noun
Аягөз	noun
аяғында	adv
аяғыш	adj
аяғыштық	noun
аядай	adj
аяз	noun
Аязата	noun
аяздай	adv
аяздату	verb
аяздау	verb
аязды	adj
аяздық	adj
аяқ	noun
аяқ-басы	noun
аяқ-қол	noun
аяқ-қолы	noun
аяқ-табақ	noun
аяқарба	noun
аяқасты	adv
аяқастынан	adv
аяқбас	noun
аяқбау	noun
аяқбәйге noun	
аяқдоп	noun
аяқдопшы	noun
аяқжақсы 	adj
аяқжол	noun
аяқкиім	noun
аяққабу	verb
аяққап	noun
аяққаптай	adj
аяққұйрықтылар	noun
аяққұр	noun
аяққы	noun
аяқмәшине noun	
аяқсу	verb
аяқсыз	adj
аяқсыту	verb
аяқтабақ	noun
аяқталған	adj
аяқталды	verb
аяқталмаған	adj
аяқталмайтын	adj
аяқталу	verb
аяқтама	noun
аяқтамау	verb
аяқтандыру	verb
аяқтану	verb
аяқтасу	verb
аяқтату	verb
аяқтау	verb
аяқтоғыз noun	
аяқты	adj
аяқша	adv
аяқшы	noun
аял	noun
аялану	verb
аялату	verb
аялау	verb
аялдама	noun
аялдама-бекініс	noun
аялдасу	verb
аялдату	verb
аялдау	verb
аялы	adj
аямай	adv
аямастан	adv
аямпаз	adj
аямпаздау	verb
аян	adj
аянбай	adv
аянбау	verb
аянкес	noun
аянкестік	noun
аяну	verb
аяншақ	adj
аяншақтанбау	verb
аяншақтану	verb
аяншақтау	verb
аяншақтық	noun
аяныш	noun
аянышты	adj
аяныштылық	noun
аяныштырақ	adj
аяң	noun
аяң-жортақ	noun
аяң-жортаң	noun
аяңдап	verb
аяңдасу	verb
аяңдату	verb
аяңдау	verb
аяңшыл	adj
аяр	adj
аярлану	verb
аярлығы	noun
аярлық	noun
аярсу	verb
аясыз 	adj
аят noun	
аят-хадис	noun
аятолла	noun
аятулкүрсі	noun
аяу	verb
аяулы	adj
аяусыз	adj
аяусыздық	noun
аяушылық	noun
аяш	noun

