а	
аба	noun
абадан	adj
абажа	noun
абажадай	adj
абажур	noun
абазин	noun
абай	adj
абайламай	adv
абайламаушылық	noun
абайлампаздық	noun
абайлап	adv
абайлаттыру	verb
абайлату	verb
абайлау	verb
абайлаушы	adj
абайлаушылық	noun
абайсыз	adj
абайсызда	adv
абайсыздық	noun
абайтану	noun
абайтанушы	noun
абайым	noun
абақ	noun
абақты	noun
абақы	adj
абалақ	adj
абалақ-сабалақ	noun
абалану	verb
абаласу	verb
абалаттыру	verb
абалату	verb
абалау	verb
абат	adj
абаттандыру	verb
абаттану	verb
абаттық	noun
абатшылық	noun
аббар	noun
аббат	noun
аббревиатура	noun
абдикация	noun
абдуктор	noun
абдукция	noun
абдыра	noun
абдыраған	adj
абдырасу	verb
абдырату	verb
абдырау	verb
абдыраушылық	noun
абдырауық	noun
аберрация	noun
аберрациялық	adj
абжад	noun
абжауқын	adj
абжылан	noun
абжыландай	adj
абзал	adj
абзалдық	noun
абзалы	adv
абзалында	
абзац	noun
абзел	noun
абиогендік	noun
абиссаль	noun
абиссин	noun
абиссиниялық	adj
абитуриент	noun
абиыр	noun
абиырсыз	adj
абиырсыздық	noun
аблаут	noun
аблығу	verb
аблықтыру	verb
абонемент	noun
абонементтелу	verb
абонементтеу	verb
абонементтік	adj
абонент	noun
абоненттік	adj
абордаж	noun
абордаждау	verb
абордажды	adj
абордаждық	adj
аборт	noun
абортивтік	adj
абразия	noun
абракадабра	noun
абрикотин	noun
абрис	noun
абсент	noun
абсентеизм	noun
абсолют	noun
абсолютизм	noun
абсолютті	adj
абсолюттік	adj
абсолюттілік	noun
абсолютшілдік	noun
абсорбент	noun
абсорбция	noun
абсорбциялау	verb
абстракт	adj
абстрактландыру	verb
абстрактлану	verb
абстрактлау	verb
абстракты	adj
абстракті	adj
абстрактілендіру	verb
абстрактілену	verb
абстрактілеу	verb
абстрактілі	adj
абстрактілік	adj
абстракционистік	adj
абстракция	noun
абстракциялану	verb
абстракциялау	verb
абстракциялаушы	noun
абстракциялы	adj
абстракциялық	adj
абстстракционизм	noun
абсцисса	noun
абұйыр	noun
абхаз	noun
абхаздық	adj
абыз	noun
абыздық	noun
абызсыну	verb
абыл-сабыл	adj
абылайша	adj
абылаңқы	noun
абылхаят	noun
абылыңқы-сабылыңқы	adj
абын	verb
абыну	verb
абынып-қабыну	verb
абың-күбің	noun
абың-қүбің	adj
абыр-гүбір	noun
абыр-дабыр	noun
абыр-жұбыр	noun
абыр-күбір	noun
абыр-сабыр	noun
абыржу	verb
абыржулы	adj
абыржушылық	noun
абыржыған	adj
абыржығыш	adj
абыржымастан	adv
абыржымау	adv
абыржып	adv
абыржысу	verb
абыржыту	verb
абырой	noun
абырой-атақ	noun
абырой-бедел	noun
абыройлы	adj
абыройлылық	noun
абыройсыз	adj
абыройсыздану	verb
абыройсыздық	noun
абысын	noun
абысын-ажын	adj
абысынды	adj
аваль	noun
авангард	noun
авангардизм	noun
авангардистік	adj
авангардтық	adj
авангардшы	noun
аванзал	noun
аванложа	noun
аванпорт	noun
аванпост	noun
аванс	noun
авансахна	noun
авансталған	adj
аванстау	verb
аванстық	adj
авансыланған	adj
авансылау	verb
авантюра	noun
авантюралық	adj
авантюризм	noun
авантюрист	noun
авантюристік	adj
авар	noun
авария	noun
авариясыз	adj
аверс	noun
авиаапат	noun
авиабағдаршам	noun
авиабаза	noun
авиабайланыс	noun
авиабилет	noun
авиабомба	noun
авиабөлім	noun
авиадесант	noun
авиажоба	noun
авиажол	noun
авиажөндеу	verb
авиазауыт	noun
авиаклуб	noun
авиакомпас	noun
авиаконструктор	noun
авиаконструкторлық	adj
авиакөкжиек	noun
авиакрейсер	noun
авиақойма	noun
авиақоректендіру	verb
авиақұрылыс	noun
авиақұрылысшы	noun
авиаматка	noun
авиамектеп	noun
авиамоделизм	noun
авиамодель	noun
авиамодельші	noun
авиамотор	noun
авианосец	noun
авиаотряд	noun
авиапарк	noun
авиаполк	noun
авиапорт	noun
авиапочта	noun
авиапошта	noun
авиапулемет	noun
авиаразведка	noun
авиасигнал	noun
авиаспорт	noun
авиаспорттық	adj
авиаспортшы	noun
авиатехник	noun
авиатозаңдандыру	verb
авиатор	noun
авиатрасса	noun
авиатүсірім	noun
авиация	noun
авиациялық	adj
авиаэскадрилья	noun
авиетка	noun
авизо	noun
ависта	noun
авитаминоз	noun
аврал	noun
австралиялық	noun
австриялық	noun
автаркия	noun
автоағаштасығыш	noun
автоара	noun
автоаспа	noun
автоаударғыш	noun
автоаудармашы	noun
автоаял	noun
автоәйнек	noun
автобаза	noun
автобазалық	adj
автобақылау	noun
автобақылаушы	noun
автобекет	noun
автоблокировка	noun
автобөлшек	noun
автобөлшектер	noun
автобус	noun
автовокзал	noun
автогараж	noun
автоген	noun
автогендік	noun
автогенші	noun
автографиялық	adj
автодабыл	noun
автодаңғыл	noun
автодәрілегіш	noun
автодиспетчер	noun
автодоғару	noun
автодоғарыс	noun
автодрезина	noun
автодром	noun
автодүкен	noun
автожарыс	noun
автожауап	noun
автожауапшы	noun
автожир	noun
автожол	noun
автожорық	noun
автожөндеу	noun
автожуғыш	noun
автожуу	noun
автожылжымалы	adj
автозауыт	noun
автокамера	noun
автокар	noun
автокеруен	noun
автоклав	noun
автокөлік	noun
автокөлікті	adj
автокөтергіш	noun
автократия	noun
автоқалам	noun
автоқатынас	noun
автоқозғалтқыш	noun
автоқозғалыс	noun
автоқосқыш	noun
автоқоспа	noun
автоқұрылыс	noun
автоқұрылысшы	noun
автол	noun
автолиз	noun
автолитография	noun
автомагистраль	noun
автомат	noun
автоматика	noun
автоматталған	adj
автоматталу	verb
автоматтандыру	verb
автоматтандырылған	adj
автоматтандырылу	verb
автоматтану	verb
автоматтау	verb
автоматты	adj
автоматтық	adj
автоматтылық	noun
автоматша	adv
автоматшы	noun
автомашина	noun
автомекен	noun
автомектеп	noun
автомеханик	noun
автомеханикалық	adj
автомобилизм	noun
автомобиль	noun
автомобильші	noun
автомоделизм	noun
автомодель	noun
автомодельші	noun
автомотодром	noun
автомотоклуб	noun
автомотоспорт	noun
автомотриса	noun
автомұнара	noun
автонауа	noun
автоним	noun
автономдық	adj
автономия	noun
автономиялы	adj
автономиялық	adj
автономияшыл	adj
автопарк	noun
автопилот	noun
автопойыз	noun
автопортрет	noun
автопісіргіш	noun
автопісіруші	noun
автор	noun
авторезеңке	noun
автореферат	noun
авторитаризм	noun
авторитарлық	adj
авторландыру	verb
авторлас	noun
авторластыру	verb
авторластырылған	adj
авторлық	noun
авторынок	noun
автосайыс	noun
автосауғыш	noun
автосборка	noun
автосервис	noun
автослесарь	noun
автосока	noun
автосоқа	noun
автосорғы	noun
автоспорт	noun
автостанция	noun
автосуарғыш	noun
автосуару	noun
автосуат	noun
автотаразы	noun
автотасымал	noun
автотежеуіш	noun
автотербеліс	noun
автотиегіш	noun
автотиеуіш	noun
автотипия	noun
автотрактор	noun
автотрансформатор	noun
автотрек	noun
автотуризм	noun
автотурист	noun
автотұрақ	noun
автотұрмыстық	adj
автотүсіргі	noun
автотүсіргіш	noun
автотізбек	noun
автотіркеме	noun
автотіркес	noun
автотіркеуіш	noun
автофертилдік	adj
автофургон	noun
автохат	noun
автохронометр	noun
автохронометраж	noun
автохтон	noun
автохтонды	adj
автохтондық	adj
автоцистерна	noun
автошабандоз	noun
автошана	noun
автошеберхана	noun
автошеру	noun
автошина	noun
автошығыр	noun
автоэпиграмма	noun
агава	noun
агат	adj
агглютинативті	adj
агглютинативтік	adj
агглютинация	noun
агент	noun
агенттік	noun
агентура	noun
агитатор	noun
агломерат	noun
агломератшы	noun
агломерация	noun
агломерациялық	adj
агностик	noun
агностикалық	adj
агностицизм	noun
агониялық	adj
аграрий	noun
аграрлы	adj
аграрлық	adj
аграрлық-өнеркәсіптік	adj
агрегат	noun
агрегаттық	adj
агреман	noun
агрессия	noun
агрессиялық	adj
агрессияшыл	adj
агрессияшылдық	noun
агрессор	noun
агрикультура	noun
агрикультуралық	adj
агробаза	noun
агробақылау	noun
агробиология	noun
агробиологиялық	adj
агробиологшы	noun
агроғалым	noun
агроғылым	noun
агроегіншілік	noun
агроереже	noun
агрожәрдем	noun
агрозауыт	noun
агрозоотехникалық	adj
агрокешен	noun
агроклиматология	noun
агроклиматтық	adj
агролесомелиоратор	noun
агролесомелиорация	noun
агромаксимум	noun
агромелиоратор	noun
агрометеорология	noun
агрометр	noun
агроминимум	noun
агроном	noun
агрономдық	
агрономия	noun
агрономиялық	adj
агронұсқау	noun
агрооқу	noun
агроөнеркәсіп	noun
агроөнеркәсіптік	adj
агропункт	noun
агротәсіл	noun
агротехник	noun
агротехника	noun
агротехникалық	adj
агроүйірме	noun
агрофизика	noun
агрофизикалық	adj
агрохимия	noun
агрохимиялық	adj
агрошара	noun
агроэкология	noun
агроэкологиялық	adj
аға	noun
аға-іні	noun
Ағадыр	noun
ағажан	noun
ағай	noun
ағайдай	noun
ағайын	noun
ағайын-ауқым	noun
ағайын-жегжат	noun
ағайын-жекжат	noun
ағайын-жұрағат	noun
ағайын-жұрт	noun
ағайын-туған	noun
ағайын-тума	noun
ағайын-туыс	noun
ағайынгершілік	noun
ағайындас	adj
ағайындасу	verb
ағайынды	noun
ағайынды-қарындас	noun
ағайындық	noun
ағайынсу	verb
ағайынсыну	verb
ағайыншыл	adj
ағайыншылау	verb
ағайыншылдық	noun
ағайыншылық	noun
ағал-жағал	adj
ағалау	verb
ағалы	adj
ағалы-қарындас	noun
ағалы-қарындасты	adj
ағалы-інілі	adv
ағалық	noun
ағамдай	adv
ағараң	noun
ағараң-ағараң	adj
ағараңдату	verb
ағараңдау	verb
ағарған	adj
ағарғанша	adv
ағартатын	adj
ағартқы	noun
ағартқыш	noun
ағарттыру	verb
ағарту	verb
ағартушы	noun
ағартушы-ұстаз	noun
ағартушылық	noun
ағартық	verb
ағартылған	adj
ағартылмаған	adj
ағартылу	noun
ағартысу	noun
ағару	verb
ағарыңқы	adj
ағасұлтан	noun
ағасыну	verb
ағат	adj
ағатай	noun
ағатайлау	verb
ағатсыз	adj
ағаттау	adj
ағаттық	noun
ағатын	adj
ағауыз	noun
ағаш	noun
ағаш-тұқым	noun
ағашат	noun
ағашаяқ	noun
ағашжегі	noun
ағашкеміргіш	noun
ағашкеміргіштер	noun
ағашкөмір	noun
ағашқұлақ	noun
ағаштай	adv
ағаштандыру	verb
ағаштану	noun
ағаштұқымы	noun
ағашты	adj
ағашты-бұталы	adj
ағаштілгіш	noun
ағашшы	noun
ағашшырмауық	noun
ағеке	noun
ағза	noun
ағзалық	adj
ағзам	adj
ағзаша	noun
ағлақ	noun
ағлөп	noun
ағу	verb
ағуа	noun
ағуалау	verb
ағуашы	noun
ағузы	verb
ағушылық	noun
ағұрық	noun
ағұсақ	noun
ағызатын	adj
ағызғыш	noun
ағыздыру	verb
ағызу	verb
ағызылатын	adj
ағызылу	verb
ағызып-тамызу	verb
ағызысу	verb
ағыл-тегіл	adv
ағылмалы	adj
ағылту	verb
ағылу	verb
ағылшын	noun
ағылшынтілді	adj
ағылшынша	adj
ағылшыншыл	adj
ағылшыншылдық	noun
ағым	noun
ағымда	noun
ағымдағы	adj
ағын	noun
ағында	noun
ағындату	verb
ағындау	verb
ағынды	adj
ағындылық	noun
ағынсыз	adj
ағыншыл	adj
ағыны	noun
ағып	adv
ағып-таму	adv
ағып-тамып	adv
ағыс	noun
ағыссыз	adj
ағысты	adj
ағытқызу	verb
ағытқыш	adj
ағытпа	noun
ағытпалы	adj
ағыттыру	verb
ағыту	verb
ағытулы	adj
ағытылған	adj
ағытылу	verb
ағытысу	verb
ада	noun
ада-гүде	adv
ада-жұда	adv
адажио	noun
адай	noun
адақ	noun
адақталу	noun
адақтасу	verb
адақтату	verb
адақтау	verb
адал	adj
адалау	verb
адалбақан	noun
адалдану	verb
адалдау	verb
адалдық	noun
адалниеттілік	noun
адалсу	verb
адалсыну	verb
адам	noun
адам-ау	noun
адам-күн	noun
адам-сағат	noun
Адамата	noun
адамата	noun
адамбаққысыз	adj
адамгершілік	noun
адамгершілікпен	adv
адамгершіліксіз	adj
адамгершіліксіздік	noun
адамгершілікті	noun
адамдай	adj
адамдарша	adv
адамдық	noun
адамзат	noun
адамзаттық	adj
адамның	adj
адампішінділер	noun
адамсит	noun
адамсу	verb
адамсүйгіштік	noun
адамсымақ	adj
адамсыну	verb
адамсыту	verb
адамтану	noun
адамтанушы	noun
адамша	adv
адамшылық	noun
аданас	noun
адаптация	noun
адаптер	noun
адаптометр	noun
адарғы	noun
адарғылау	verb
адас	noun
адасқақ	noun
адасқан	adj
адасқандық	noun
адасқызу	verb
адасқыш	adj
адастыру	verb
адасу	verb
адасушылық	noun
адат	noun
адау-қадау	noun
адвентив	noun
адвербиалдану	noun
адвербиалды	adj
адвокат	noun
адвокаттық	adj
адвокатура	noun
адекват	adj
адекваттық	adj
аденома	noun
аджар	noun
аджарлық	adj
адиабаттық	adj
администратор	noun
адмирал	noun
адмиралдық	adj
адмиралтейство	noun
адреналин	noun
адрес	noun
адресант	noun
адресат	noun
адсорбент	noun
адсорбция	noun
адуын	adj
адуындану	verb
адуындату	verb
адуындау	verb
адуынды	adj
адуындық	noun
адуындылық	noun
адъективтену	noun
адъективті	adj
адъюнкт	noun
адъютант	noun
адъютанттық	adj
адыгей	noun
адым	noun
адымдағыш	noun
адымдап	adv
адымдату	verb
адымдау	verb
адымдаушы	noun
адымдауыш	noun
адымды	adj
адын	noun
адыр	noun
адыр-адыр	adj
адыр-бұдыр	adj
адыр-бұдырлы	adj
адыр-бұдырлық	adj
адыр-гүдір	adv
адыра	noun
адырайған	adj
адырайту	verb
адырақ	noun
адырана	noun
адыраң-адыраң	adv
адыраңдасу	verb
адыраңдату	verb
адыраңдау	verb
адыраңдық	noun
адыраспан	noun
адыраю	verb
адырлы	adj
адырлы-бұдырлы	adj
адырлық	noun
адырмақ	noun
адырмақ-бұдырмақ	adj
адырмақты	adj
адырна	noun
адырсыз	adv
адырсымак	adj
адыршық	adj
ажа	noun
ажайып	adj
ажал	noun
ажал-тажал	adv
ажалдай	adv
ажалды	adj
ажалсыз	adj
ажалсыздық	noun
ажам	noun
ажан	noun
ажапсыну	verb
ажар	noun
ажар-көрік	noun
ажар-сымбат	noun
ажарлағыш	noun
ажарлайтын	adj
ажарландыру	verb
ажарлану	verb
ажарлау	verb
ажарлаушы	noun
ажарлауыш	noun
ажарлы	adj
ажарлы-сымбатты	adj
ажарлылық	noun
ажарсыз	adj
ажарсыздандырылу	verb
ажарсыздану	verb
ажарсыздық	noun
аждаһа	noun
аждаһадай	adv
аждаһаша	noun
ажио	noun
ажиотаж	noun
ажуа	noun
ажуа-мазақ	noun
ажуа-мысқыл	noun
ажуа-сықақ	noun
ажуаласу	verb
ажуалау	verb
ажуалы	adj
ажуалық	adj
ажуасыз	adj
ажуашыл	adj
ажуашылдық	noun
ажүн	noun
ажым	noun
ажымдану	verb
ажырағысыз	adj
ажырағыштық	noun
ажырайған	adj
ажырайту	verb
ажырайтын	adj
ажырайтындық	adj
ажырайысу	verb
ажырамай	adv
ажырамайтын	adj
ажырамалы	adj
ажырамас	adj
ажырамдылық	noun
ажырасқан	adj
ажырастыру	verb
ажырасу	verb
ажыратқы	adj
ажыратқызу	verb
ажыратқыш	noun
ажыратқыштық	adj
ажыратпай	adv
ажыраттыру	verb
ажырату	verb
ажыратушы	noun
ажыратылмайтын	adj
ажыратылу	verb
ажырау	verb
ажыраю	verb
ажырғы	adj
ажырық	adj
ажырым	noun
аз	adv
аз-аз	adv
аз-аздан	adv
аз-аздап	adv
аз-ақ	adv
аз-кем	adv
аз-көп	adv
аз-маз	adv
аз-мұз	adv
аза	noun
аза-мұң	noun
азагер	noun
азагүл	noun
азайған	adj
азайғыш	noun
азайтқыш	noun
азайттыру	verb
азайту	verb
азайтылған	adj
азайтылу	verb
азайтыңқырау	adj
азалану	verb
азалау	verb
азалы	adj
азамат	noun
азаматтай	adj
азаматтық	noun
азаматша	noun
азаматшылық	noun
азан	noun
азан-қазан	noun
азанама	noun
азанғы	adj
азанда	noun
азандату	verb
азандау	verb
азандық	adj
азаннан	adv
азаншы	noun
азап	noun
азап-бейнет	noun
азап-қорлық	noun
азапкер	noun
азапсыз	adj
азапта	adj
азапталу	verb
азаптандыру	verb
азаптану	verb
азаптанушылық	noun
азаптанып	adv
азаптату	verb
азаптау	verb
азаптаушы	noun
азаптаушылық	noun
азапты	adj
азар	noun
азарда-безер	adv
азарлану	verb
азарлау	verb
азасыз	adj
азат	adj
азатбас	noun
азатжол	noun
азаткер	noun
азаттау	verb
азаттық	noun
азатшы	noun
азатшыл	adj
азатшылық	noun
азаю	verb
азаюшы	noun
азаюшылық	noun
азбан	noun
азбандық	noun
азбанқұл	noun
азбар	noun
азбеніш	noun
азған	adj
азған-тозған	adj
азғана	adv
азғантай	noun
азғын	adj
азғын-тозғын	adj
азғындаған	adj
азғындану	verb
азғындар	noun
азғындату	verb
азғындау	verb
азғындаушылық	noun
азғындауы	noun
азғындық	noun
азғырғыш	noun
азғырғыштық	noun
азғыру	verb
азғырушы	noun
азғырушылық	noun
азғырылған	adj
азғырылу	verb
азғырынды	noun
азғырып-жазғыру	verb
аздаған	adv
аздан-аздан	adv
аздап	adv
аздап-аздап	adv
аздату	verb
аздау	adv
азды-кем	adv
азды-кемді	adv
азды-көпті	noun
аздық	noun
аздыратын	adj
аздырғыш	adj
аздырма	noun
аздырту	verb
аздыру	verb
аздырушы	noun
аздырушылық	noun
аздырып-тоздыру	verb
азимут	noun
Азия	noun
азиялық	noun
азқылтықты	
азқылтықтылар	noun
азобояғыш	noun
азобірігу	noun
азокірнелер	noun
азоқосылыс	noun
азоқұраушылар	noun
азот	noun
азотсіңіруші	noun
азотталу	verb
азоттандырушы	noun
азоттану	verb
азоттау	verb
азотты	adj
азоттық	adj
азошәует	noun
азсынбау	verb
азсынған	adj
азсыну	verb
азсынушылық	noun
азу	verb
азуағаш	noun
азулану	verb
азулау	verb
азулы	adj
азулылық	adj
азусыз	adj
азусыздық	noun
азушылық	noun
азшылық	noun
азық	noun
азық-түлік	noun
азық-түліктік	adj
азықбулауыш	noun
азықжуғыш	noun
азықсыз	adj
азықсыздық	noun
азықсырау	noun
азықтандыру	verb
азықтану	verb
азықты	adj
азықтық	adj
азықхана	noun
азықцех	noun
азын-аулақ	adv
азын-шоғын	adv
азынаған	adj
азынасу	verb
азынату	verb
азынау	verb
азынаулақ	noun
азында	noun
азыңқы	adj
азып	adj
азып-тозған	adj
азып-тозу	verb
азып-тозушылық	noun
азырақ	adv
азырқанбау	noun
азырқану	verb
ай	noun
Ай	noun
ай-жай	adv
ай-түй	adv
ай-шай	noun
ай-шайсыз	adv
айбалдақ	noun
айбалдырған	adj
айбалта	noun
айбалталы	adj
айбалық	noun
айбар	adj
айбарақ	noun
айбарланған	adj
айбарландыру	verb
айбарлану	verb
айбарлы	adj
айбарлылық	noun
айбарсыз	adj
айбарсыздық	noun
айбат	noun
айбатмия	noun
айбатсыз adj
айбатсыздық	noun
айбаттандыру	verb
айбаттану	verb
айбатты	adj
айбаттық	noun
айбаттылық	noun
айбық	adj
айбын	noun
айбынды	adj
айбындылық	noun
айбындыру	verb
айбынсыз	adj
айбынсыздық	noun
айбынту	verb
айбыну	verb
айва	noun
айгөлек	noun
айгүл	noun
айғабақ	noun
айғай	noun
айғай-аттан	noun
айғай-сүрен	noun
айғай-сүрең	noun
айғай-ұйғай	noun
айғай-шу	noun
айғайлаған	adj
айғайласу	verb
айғайлату	verb
айғайлау	verb
айғайсыз	adv
айғайшы	noun
айғайшыл	adj
айғақ	noun
айғақкер	noun
айғақсыз	adj
айғақсыздық	noun
айғақталу	verb
айғақтама	noun
айғақтату	verb
айғақтау	verb
айғақтаушы	noun
айғақты	adj
айғақтылық	noun
айғақшы	noun
айғыз	noun
айғыз-айғыз	adj
айғыздаған	adj
айғыздалған	adj
айғыздалу	verb
айғыздану	verb
айғыздату	verb
айғыздау	verb
айғыр	noun
айғыржуа	noun
айғырқияқ	noun
айғырлық	adj
айғырсасыр	noun
айда	verb
айдағыш	adj
айдай	adv
айдайтын	
айдақ-жайдақ	adj
айдақ-сайдақ	adv
айдақтату	verb
айдала	noun
айдалатын	adj
айдалған	adj
айдалмаған	adj
айдалу	verb
айдалушы	noun
айдалыну	verb
айдалып	adv
айдам	noun
айдама	noun
айдамал	adj
айдамалау	verb
айдапсал	adj
айдар	noun
айдарланған	adj
айдарлы	noun
айдарман	noun
айдарсыз	adj
айдарша	adv
айдаршөп	noun
айдаршық	noun
Айдасан	noun
айдасу	verb
айдатқызу	verb
айдаттыру	verb
айдату	verb
айдау	verb
айдаулы	adj
айдаусыз	adj
айдаушы	noun
айдауыл	noun
айдауыш	adj
айдаһар	noun
айдаһардай	adj
айдаһарша	adv
айды-айынша	adv
айдын	noun
айдындай	adj
айдындану	verb
айдынды	adj
айдынсыз	adj
айдың	adj
айжарық	noun
айкезбе	noun
айкидо	noun
айкидошы	noun
айқабақ	noun
айқай	noun
айқай-даңғаза	noun
айқай-қиқу	noun
айқай-сүрен	noun
айқай-ұйқай	noun
айқай-ұран	noun
айқай-шу	noun
айқайлағыш	noun
айқайлап-ұйқалау	verb
айқайласу	verb
айқайлату	verb
айқайлау	verb
айқайлы	adj
айқайсыз	adv
айқайшы	noun
айқайшыл	adj
айқайшылдық	noun
айқайың	noun
айқаласу	verb
айқалату	verb
айқалау	verb
айқара	adv
айқару	verb
айқарылу	adj
айқас	noun
айқасқан	adj
айқаспа	noun
айқаспалы	adj
айқастыру	verb
айқастырылу	verb
айқасу	verb
айқұлақ	noun
айқын	adj
айқындағыш	noun
айқындалу	verb
айқындама	noun
айқындану	verb
айқындату	verb
айқындау	verb
айқындаушы	
айқындауыш	noun
айқындық	noun
айқындылық	noun
айқынырақ	noun
айқыш	adj
айқыш-ұйқыш	adj
айқыш-ұйқыштану	
айқышталу	noun
айқыштану	verb
айқыштату	verb
айқыштау	verb
айқышты	adj
айла	noun
айла-амал	noun
айла-әдіс	noun
айла-әрекет	noun
айла-қулық	noun
айла-тәсіл	noun
айла-тұзақ	noun
айла-шарғы	noun
айла-шарғылы	adj
айлакер	noun
айлакерлік	noun
айлакес	noun
айлакестік	noun
айлақ	noun
айлақор	noun
айлақорлық	adj
айлақтау	verb
айлақты	adj
айлақтық	adj
айлақылану	verb
айлалау	verb
айлалы	adj
айлалық	noun
айлалылық	noun
айланкес	adj
айлант	noun
айлану	verb
айланшөп	noun
айланысу	verb
айлап	adv
айлап-апталап	adv
айлап-жылдап	adv
айлапат	adj
айлас	adj
айлас-мұңдас	adj
айласыз	adj
айласыздық	noun
айлауық	noun
айлашы	noun
айлашыл	noun
айлы	adj
айлық	adj
айма-ай	adv
аймақ	noun
аймақаралық	adj
аймақкөл	noun
аймақтану	verb
аймақты	adj
аймақтық	adj
аймалақ	noun
аймаласу	verb
аймалату	verb
аймалау	verb
аймандай	adj
аймауыт	noun
аймауыттай	adj
аймыш-ұймыш	adj
аймыштау	verb
аймышты	adj
аймышы	noun
айна	noun
айнадай	adj
айнакөз	noun
айнала	noun
айнала-төңірек	noun
айналадағы	adj
айналайын	noun
айналақтау	verb
айналасы	noun
айналасында	prep
айналау	noun
айналғыш	noun
айналдыра	prep
айналдырғылау	verb
айналдырғыш	adj
айналдырма	noun
айналдыру	verb
айналдырушы	noun
айналдырылу	verb
айналдырып	adv
айналқастау	verb
айналма	noun
айналмақ	noun
айналмалы	adj
айналмалылық	noun
айналсоқ	noun
айналсоқтату	verb
айналсоқтау	verb
айналту	verb
айналу	verb
айналушы	noun
айналшақ	adj
айналшық	noun
айналшықтау	verb
айналы	adj
айналық	adj
айналым	noun
айналымды	adj
айналымдық	adj
айналымдылық	noun
айналып-толғану	verb
айналыс	noun
айналыстыру	verb
айналысу	verb
айналысушы	noun
айналысушылық	noun
айнам	noun
айнамұз	noun
айнаш	noun
айнаша	noun
айну	verb
айнығыш	adj
айнығыштық	noun
айнымайтын	adj
айнымал	adj
айнымалы	adj
айнымалылық	noun
айнымас	adj
айнымау	verb
айнытқызу	verb
айнытпай	adv
айнытпау	
айныттыру	verb
айныту	verb
айпап-жайпау	verb
айпара	noun
айпарадай	adj
айран	noun
айран-асыр	noun
айран-шалап	noun
айрандай	adj
айранкөз	adj
айранкөздену	verb
айрауық	noun
айрық	noun
айрықша	adj
айрықшаланған	adj
айрықшалану	verb
айрықшалық	noun
айрылған	adj
айрылмайтын	adj
айрылмас	adj
айрылу	verb
айрылыс	noun
айрылысқан	adj
айрылысу	verb
айсберг	noun
айсор	noun
айсорлық	adj
айсыз	adj
айсырға	noun
айт	noun
айт-айт	noun
айт-түй	noun
айт-үйт	noun
айт-шу	noun
айт-шулеу	verb
айта-айта	adv
айтақ	noun
айтақсыз	adj
айтақтату	verb
айтақтау	verb
айтақтаушы	noun
айтақшы	noun
айтақшыл	adj
айтақыр	adj
айталық	misc
айтар-айтпаста	adv
айтар-айтпастан	adv
айтарлық	adj
айтарлықтай	adj
айтқандай	adv
айтқызу	verb
айтқысыз	adj
айтқыш	noun
айтпақшы	adv
айтпау	verb
айтсаңыздаршы	verb
айттату	verb
айттау	verb
айттық	verb
айттыру	verb
айттырулы	adj
айттырусыз	adj
айттырушы	noun
айттырылу	verb
айттырысу	verb
айту	verb
айтулы	adj
айтусыз	adj
айтушы	adj
айтуынша	noun
айтұяқ	noun
айтшы	verb
айтшыласу	verb
айтшылау	verb
айтылатын	adj
айтылған	adj
айтылмыш	adj
айтылу	verb
айтылыс	noun
айтымпаз	noun
айтып	verb
айтып-айтпай	adv
айтыс	noun
айтыс-жанжал	noun
айтыс-керіс	noun
айтыс-талас	noun
айтыс-тартыс	noun
айтыс-тартыссыз	adv
айтыс-тартысты	adj
айтыскер	noun
айтыскерлік	noun
айтысқұмар	noun
айтысқұмарлық	noun
айтыссыз	adv
айтыстыру	verb
айтысу	verb
айтысушы	noun
айтысып-тартысу	verb
айуан	noun
айуанат	adj
айуандай	adj
айуандық	noun
айуандықпен	adv
айуанша	adv
айуаншылық	noun
айхай	noun
айһай	noun
айшалғы	noun
айшанақ	noun
айшолпы	noun
айшөрек	noun
айшық	noun
айшықсыз	adj
айшықталу	verb
айшықтама	noun
айшықтану	verb
айшықтату	verb
айшықтау	verb
айшықты	adj
айшықтылық	noun
айшылық	adj
айы-күні	noun
айығатын	adj
айығу	verb
айыз	adj
айық	adj
айыққан	adj
айықпаған	adj
айықпай	adv
айықпайтын	adj
айықпайынша	noun
айықтыратын	adj
айықтырғыш	noun
айықтыру	verb
айыл	noun
айыл-тартпа	noun
айыл-тұрман	noun
айылбас	noun
айылдау	verb
айылды	adj
айылдық	adj
айылжапырақ	noun
айылжуа	noun
айылқияқ	noun
айылқұр	noun
айылым	noun
айым	noun
айым-ау	noun
айым-қайым	noun
айына	noun
айында	adv
айында-жылында	adv
айып	noun
айып-алаңы	noun
айып-анжы	noun
айып-аралығы	noun
айып-күнә	noun
айып-кінә	noun
айып-шам	noun
айыпақы	noun
айыпдоп	noun
айыпкер	noun
айыпкерлік	noun
айыппұл	noun
айыпсыз	adj
айыпсыздық	noun
айыпсыну	verb
айыптағушылық	noun
айыпталу	verb
айыпталушы	noun
айыптас	noun
айыптату	verb
айыптау	verb
айыптаушы	noun
айыптаушылық	noun
айыпты	adj
айыптық	adj
айыптылық	noun
айыпшыл	
айыр	noun
айыр-айқас	
айыратын	adj
айырбақай	
айырбас	noun
айырбасқор	noun
айырбасталатын	
айырбасталу	verb
айырбасталым	
айырбастампаз	noun
айырбастату	verb
айырбастау	verb
айырбасу	noun
айырбез	
айырғы	noun
айырғысыз	adv
айырғыш	noun
айырқұйрық	noun
айырлану	
айырлау	verb
айырлы	
айырма	noun
айырмалы	adj
айырмалық	adj
айырмасыз	adj
айырмашылық	noun
айырмүйіз	
айырмүіз	
айырөркеш	
айырсадақ	noun
айырт	noun
айырту	verb
айыртушы	
айыртұяқ	
айыртұяқты	
айыру	verb
айырулы	
айырушы	
айырушылық	noun
айырша	
айыршық	noun
айырық	
айырықсыз	adj
айырықты	
айырылатын	adj
айырылған	adj
айырылғандай	
айырылмайтын	adj
айырылмас	adj
айырылмастан	
айырылмастық	
айырылу	verb
айырылыс	noun
айырылысу	verb
айырым	adj
айырымдау	noun
айырып-қосқыш	noun
айырыс	
айырысу	verb
айырысушы	
академизм	noun
академизмдік	
академик	noun
академия	noun
академиялық	adj
акация	noun
акбар	adj
аквакешен	
акваланг	noun
аквалангшы	
аквамарин	
акванавт	
акварель	noun
акварельді	
акварельші	
аквариум	noun
акватория	noun
акведук	noun
аквилон	
аккомпанемент	noun
аккомпаниатор	
аккорд	noun
аккордеон	noun
аккордеоншы	
аккордтық	
аккредитив	
аккредитивтеу	
аккредитивті	
аккредитивтік	adj
аккредитивтіркелген	
аккредиттелген	adj
аккредиттелу	
аккредиттеу	
аккузатив	
аккумулятор	noun
аккумуляторлы	adj
аккумуляция	noun
аккумуляциялану	verb
аккумуляциялау	verb
аккумуляциялық	adj
акмеизм	noun
акр	noun
акрил	
акро	
акробат	noun
акробатика	
акробатикалық	adj
акробаттық	
акроним	
акроөлең	
акрополь	
аксельбант	
аксессуар	noun
аксиома	noun
аксиомалық	
аксиоматикалық	adj
аксирис	
акт	noun
акт-ереже	
актер	noun
актерлік	adj
актив	noun
активист	noun
активтелу	verb
активтенген	adj
активтендіру	verb
активтендірушілік	noun
активтендірілу	verb
активтену	verb
активтеу	verb
активті	adj
активтік	noun
актиний	
актиния	noun
актриса	noun
актуалды	adj
актуалдық	noun
актуальдандыру	verb
актілену	verb
актілеу	verb
актілі	
актілік	adj
акула	noun
акупунктура	
акустика	
акустикалық	adj
акушер	
акушерка	noun
акушерлік	
акцент	noun
акцентология	noun
акцентсіз	
акценттеу	
акцентуация	noun
акцентуациялық	adj
акцепт	
акцептеу	
акцептор	
акцепттелген	adj
акцепттелу	
акцептік	
акцесті	
акциденттік	adj
акциз	
акцизделу	
акциздік	
акцизсіз	
акциология	noun
акционер	noun
акционерлік	adj
акция	noun
Ақ	
ақ	adj
ақ-қара	
ақаба	
ақай	
ақай-тоқай	
ақайран	
ақайрандану	
ақайту	verb
ақалақшы	
ақалтеке	
ақан	
ақаншы	
ақаң	noun
ақар-шақар	adj
ақарлы-шақарлы	adj
ақау	noun
ақаулану	verb
ақаулы	
ақаулық	noun
ақаулылық	
ақаусыз	
ақаусыздық	noun
ақаутапқы	
ақауыз	
ақаю	
ақбайпақ	
ақбайтал	
ақбақай	
ақбалшық	
ақбалық	
ақбас	noun
ақбасшөп	
ақбата	noun
ақбауыр	
ақбидай	
ақбикеш	noun
ақбоз	
Ақбозат	
ақбөкен	noun
ақбөртелену	
ақбұғы	
ақбұзаубас	
ақгвардия	adj
ақгвардияшыл	noun
ақгүл	noun
ақгүлді	
ақдабы	
ақдегелек	
ақжағал	
ақжағалақ	
ақжағалдану	
ақжайма	noun
ақжал	
ақжалбыз	
ақжапалақ	
ақжапырақ	noun
Ақжар	
ақжарқын	noun
ақжарқындылық	noun
ақжауын	
ақжелек	noun
ақжелкек	
ақжелкен	
ақжем	
ақжемдену	
ақжиде	noun
ақжол	
ақжолтай	adj
ақжуа	
ақжусан	
ақжүгері	
ақжүзген	
ақжүрек	adj
ақжүректік	noun
ақзон	
ақи	
ақи-тақи	
ақиқат	noun
ақиқаттау	verb
ақиқаттық	noun
ақиқаттылық	noun
ақиқатшыл	adj
ақиқатшылдық	noun
ақиқаты	adv
ақиқатында	adv
ақилану	
ақирет	
ақиреттік	adj
ақиту	verb
ақиық	adj
ақиысу	verb
ақию	verb
ақкекілік	
ақкекіре	noun
ақкелін	
ақкеріш	
ақкеріштену	
ақкес	
ақкиіз	
ақкөбелек	
ақкөде	
ақкөз	
ақкөздену	
ақкөйлек	
ақкөңіл	adj
ақкөңілді	
ақкөңілдік	noun
ақкөңілділік	noun
ақкөңілділіктен	
ақкөш	noun
ақкүйе	
ақкүлте	
ақкіс	noun
аққаз	
аққайнар	
аққайрақ	
аққайран	
аққайың	
аққайыңшөп	
аққала	noun
аққалақ	noun
аққанат	
аққандылық	noun
аққаңбақ	
аққаптал	
аққарағай	
аққарқара	
аққат	
аққатпа	
аққия	noun
аққодал	
аққой	
аққолтық	
аққонақ	
аққоңырбас	
Аққорған	
аққоян	
аққу	noun
Аққу	
аққурай	
аққұба	
аққұбалау	
аққұбаша	
аққұйрық	noun
аққұла	adv
аққұлақ	noun
аққұман	
аққұмырсқа	
аққұр	
аққұс	
аққұтан	noun
аққылтан	
аққылтық	
аққыш	adj
аққыштық	
ақлақ	
ақләйлек	
ақмағамбет	noun
ақмақтанып	adv
ақмақтарша	
ақмақтықпен	adv
ақмамық	
ақмарал	
ақмарқа	
ақмарту	verb
ақмасақтық	
ақмия	noun
ақмұрт	noun
ақмыя	
ақнабат	
ақнауат	
ақнәсілді	
ақниет	
ақниетті	
ақот	
ақпа	adj
ақпақұлақ	
ақпақұлақтану	verb
ақпалау	
ақпан	noun
ақпан-тоқпан	
ақпандату	verb
ақпар	noun
ақпар-кітапша	noun
ақпарат	noun
ақпаратнама	
ақпараттандыру	verb
ақпараттану	
ақпараттау	
ақпараттық	adj
ақпараттық-анықтамалық	
ақпараттық-талдау	
ақпараттылық	noun
ақпарлау	verb
ақпартану	
ақпартізім	noun
ақпаршы	noun
ақпатаяқ	
ақпейіл	adj
ақпейілді	adj
ақпейілділік	noun
ақсабақты	
ақсағал	noun
Ақсай	
ақсайит	
ақсақ	adj
ақсақ-тоқсақ	
ақсақал	noun
ақсақалдай	
ақсақалды	adj
ақсақалдық	
ақсақтық	noun
ақсаң	
ақсаңдату	verb
ақсаңдау	verb
ақсаңқырау	
ақсаңырауқұлақ	
ақсап-тоқсап	
ақсарағат	
ақсарбас	
ақсары	noun
ақсарылау	
ақсату	verb
ақсау	verb
ақсаусақ	noun
ақсаусақтық	
ақсексеуіл	
ақселеу	
ақсерке	noun
ақсиған	
ақсирақ	
ақсирақтану	verb
ақситу	verb
ақсию	verb
ақсора	
ақсорпа	
ақсөл	
ақсөңке	
ақсу	
Ақсуат	
ақсұлама	
ақсұңқар	
ақсұңқардай	
ақсұп	
ақсүйек	noun
ақсүйектер	noun
ақсүйектік	adj
ақсүт	
ақсүттену	
ақсыну	verb
ақсыр	
ақсырау	verb
ақсырғақ	
ақсырттан	
ақта	noun
ақтабан	noun
ақтағыр	
ақтады	verb
ақтайтын	
ақтал	noun
ақталған	adj
ақталқан	
ақталмаған	adj
ақталу	verb
ақталушы	
ақтамақ	
ақтамақгүл	noun
ақтамыр	
ақтан	
ақтаңдақ	noun
ақтаңдақтану	verb
ақтаңдақтар	
ақтарғыш	
ақтармалау	verb
ақтарту	verb
ақтару	verb
ақтары	
ақтарылған	adj
ақтарылу	verb
ақтарыну	verb
ақтарып-төңкеру	verb
ақтарып-төңкерістіру	verb
ақтарыс	
ақтарыстыру	
ақтарысу	verb
ақтас	
ақтаспа	
ақтаспашөп	
ақтасу	
ақтатқызу	
ақтаттыру	verb
ақтату	verb
ақтау	verb
ақтауқалақай	
ақтаулы	
ақтаутан	
ақтаушы	noun
ақташы	
ақтаяқ	
ақтәңді	
ақтерек	
ақтиін	noun
ақтоған	
ақтопалаң	
ақторға	
ақторғай	noun
Ақтөбе	
ақтөс	
ақтұйғын	
ақтұмсық	
ақтұнжыр	
ақтұңғиық	
ақтұт	
ақтұяқ	
ақтүйежоңышқа	
ақтүйнек	noun
ақтүйіршік	
ақтүлкі	noun
ақтүн	
ақтүтек	
ақтүтектену	verb
ақты	
ақты-көкті	
ақты-қара	
ақты-қаралы	
ақты-қызылды	
ақтығында	adv
ақтық	noun
ақтылы	
ақтылы-қаралы	
ақтырна	
ақтышқақ	
ақтышқан	
ақтігер	
ақтікен	
ақуыз	noun
ақуызды	
ақұнтақ	
ақұрық	
ақүй	
Ақүй	
ақүйлі	
ақүрпек	
ақүрпектену	verb
ақүртек	
АҚШ	noun
ақша	noun
ақша-несие	
ақша-салық	
ақша-сауда	
ақша-тауар	
ақшабақ	
ақшагер	
ақшағала	
ақшаған	
ақшадай	
ақшайыр	
Ақшақар	noun
ақшақұмар	
ақшалай	
ақшалай-заттай	
ақшалану	verb
ақшалау	verb
ақшалы	adj
ақшам	
ақшамсоқыр	
ақшаңдақ	
ақшаңдақтану	verb
ақшаңдату	verb
ақшаңдау	verb
ақшасанау	
ақшасыз	adj
ақшасыздық	noun
ақшатай	
ақшатау	
ақшатыр	
ақшелек	
ақшеңгел	
ақшешек	
ақшешекше	
ақшиту	verb
ақшию	verb
ақшоқан	
ақшолақ	
ақшом	
ақшомшы	
ақшомыр	
ақшөп	
ақшуақ	
ақшұнақ	
ақшыл	adj
ақшылдандыру	verb
ақшылдану	verb
ақшылдау	adj
ақшылдық	noun
ақшылт	adj
ақшылттау	adj
ақшылтым	
ақшырайлы	noun
ақшытыр	
ақшіл	
ақшілік	
ақшірік	
ақы	noun
ақы-пұл	noun
ақы-пұлсыз	adv
ақық	noun
ақықтау	
ақықты	
ақыл	noun
ақыл-айла	
ақыл-ес	noun
ақыл-естілік	noun
ақыл-кеңес	noun
ақыл-көрік	noun
ақыл-ой	noun
ақыл-өсиет	
ақыл-парасат	noun
ақыл-парасаттылық	noun
ақыл-сана	
ақылгөй	noun
ақылгөйлік	
ақылгөйсу	verb
ақылгөйсіну	verb
ақылға	
ақылдас	noun
ақылдасқызу	verb
ақылдастыру	verb
ақылдасу	verb
ақылды	adj
ақылдық	noun
ақылдылық	noun
ақылдымсу	verb
ақылдысымақ	noun
ақылдысыну	verb
ақылман	noun
ақылмандық	noun
ақылмен	adv
ақылсерік	
ақылсөз	
ақылсыз	noun
ақылсыздану	verb
ақылсыздық	noun
ақылсыну	verb
ақылшы	noun
ақылшы-ұстаз	noun
ақылы	adj
ақылылық	
ақымақ	adj
ақымақтанған	
ақымақтандыру	verb
ақымақтану	verb
ақымақтау	adj
ақымақтық	noun
ақымақшылық	noun
ақын	noun
ақын-жазушы	
ақын-жазушылар	
ақындық	adj
ақынжанды	
ақынжандылық	noun
ақынсу	verb
ақынсымақ	
ақынсыну	verb
ақыр	noun
ақыр-тақыр	adv
ақыр-шек	noun
ақырайту	verb
ақыраңдату	verb
ақыраңдау	verb
ақырап	noun
Ақырап	
ақырау	
ақыраю	verb
ақырғы	adj
ақырет	noun
ақыреттік	
ақырзаман	noun
ақырлау	verb
ақырту	verb
ақыру	verb
ақыры	adv
ақырын	adv
ақырын-ақырын	adv
ақырында	adv
ақырындап	adv
ақырындату	verb
ақырындатылған	adj
ақырындау	verb
ақырындық	noun
ақырынырақ	
ақырып-бақыру	verb
ақырып-жекіру	verb
ақырып-зекіру	verb
ақырып-шақыру	verb
ақырысу	verb
ақысыз	adj
ақысыз-пұлсыз	
ақыт	
ақірімшік	
ақэмигрант	
ал	misc
ал-дал	
ал-сал	
ала	adj
ала-бөле	adv
ала-бөтен	adj
ала-құла	adj
ала-құлалық	noun
алааяқ	
алабажақ	adj
алабажақтану	verb
алабажақтық	noun
алабажыр	
алабалта	
алабарқын	adj
алабас	
алабота	noun
алабөрту	verb
алабөтен	
алабөтендік	noun
алабұға	noun
алабұлбұл	
алабұлдыр	
алабұлдырық	
алабұрту	verb
алабұта	
алабүйі	
алабүлік	
алабүрге	
алагеуім	
алагеуімдену	verb
алагөбе	
алагөбеде	
алагөбең	
алагүлік	noun
алағай	
алаған	
алағандық	noun
алағаншық	
алағаншықтану	verb
алағаншықтау	verb
алағат	adj
алағұс	noun
алағызу	verb
аладомбай	
алажаулы	adj
алажертесер	
алай	adv
алай-бұлай	
алай-былай	
алай-дүлей	noun
алай-түлей	
алайда	misc
алайту	verb
алакеуімнен	adv
алакөз	
алакөздену	
алакөздік	
Алакөл	
алакөлеңке	noun
алакөлеңкеден	adv
алакөлеңкелену	
алакөңіл	
алакөңілділік	
алакүйек	
алакүлтелі	
алакүшік	
алақ	
алақ-алақ	
алақ-жалақ	
алақ-жұлақ	
алақ-салақ	adj
алақаз	
алақай	noun
алақайлау	verb
алақан	noun
алақанат	
алақандай	adj
алақандау	verb
алақансоқпақ	
алақап	
алақарақ	
алақарға	
алақаудан	
алақиғаш	
алақоғыр	
алақол	adj
алақолдық	
алақолдылық	
алақоржын	noun
алақтасу	verb
алақтату	verb
алақтау	verb
алақумай	
алақұйын	
алақұйындану	
алақұмай	
алақұрт	
алақұрттау	verb
алақшы	
алақшын	
алақызба	
алаламай	
алаламайтын	adj
алалану	
алалату	verb
алалау	verb
алалаушылық	noun
алалы	
алалы-құлалы	adj
алалық	noun
алалықсыз	
аламай	noun
аламайлау	
аламайлы	
аламан	noun
аламан-тасыр	noun
аламандау	verb
аламандық	noun
аламық	
аламыш	adj
аламыштану	verb
аламыштату	verb
аламыштау	verb
алан	
аланды	
алаң	noun
алаң-бұлаң	adj
алаң-елең	
алаңғасар	adj
алаңғасарландыру	verb
алаңғасарлану	verb
алаңғасарланушылық	noun
алаңғасарланып	
алаңғасарлық	noun
алаңғыт	adj
алаңдатарлық	
алаңдатпа	
алаңдату	verb
алаңдау	verb
алаңдаушылық	noun
алаңдық	noun
алаңқай	noun
алаңқы	
алаңсыз	adj
алаңсыздық	noun
алаңша	noun
алаңшық	noun
алаңшыл	
алаөкпе	
алаөрмекші	
алап	noun
алап-жалап	
алапа	noun
алапай	noun
алапай-талапай	noun
алапат	noun
алапаттану	
алапатты	
алапаттық	
алапес	noun
алапестей	
алапестену	verb
алапты	adj
аларман	noun
аларту	verb
алару	verb
алас	
алас-күлес	noun
алас-қапас	noun
алас-қапаста	
алас-құлас	
аласа	adj
аласабыр	
аласалау	adj
аласалық	adj
аласапақ	
аласапыран	noun
аласапыраншыл	
аласарақ	adv
аласарту	verb
аласару	verb
аласат	noun
аласауысқан	
аласәуле	
аласәулелену	
аласпан	
аласталған	noun
аласталу	verb
аластату	verb
аластау	verb
аластаушы	
аласуан	noun
аласұрған	
аласұрғызу	verb
аласұрту	verb
аласұру	verb
аласұрыс	noun
аласы	noun
аласы-бересі	
аласыз	
аласылы	noun
алатаң	adj
алатопалаң	
алатұяқ	adj
алатышқан	noun
алатізбекті	
алатікен	
алау	noun
алау-далау	
алау-жалау	
алаудай	
алаукеуімнен	adv
алаулану	verb
алаулату	verb
алаулау	verb
алаулы	adj
алауоттық	
алаурату	verb
алаурау	verb
алауыз	
алауыздық	noun
алаш	noun
алаша	noun
алашабыр	
алашақ	noun
алашапқын	
Алашорда	
алашордалық	
алашордашы	
алашордашыл	
алаштау	
алашшыл	
алаю	verb
алаяқ	noun
алаяқтық	noun
алба-далба	
алба-жалба	
алба-жұлба	
албан	adj
албар	noun
албар-қора	noun
албарлы	
албасты	noun
албастыдай	
албаты	adv
албау	noun
албыр-жалбыр	adj
албыр-салбыр	noun
албыраған	adj
албырап-жалбырау	verb
албырату	verb
албырау	verb
албырт	adj
албырттану	verb
албырттық	noun
албырту	verb
албыт	
албыттану	verb
албыттық	noun
албыту	verb
алгебра	noun
алгебралық	
алгебрашы	
алгоритм	noun
алгоритмдік	
алгоритмизация	noun
алгорифм	
алға	prep
Алғабас	
алғай-шалғай	noun
алған	
алғанша	
алғаны	noun
алғау	noun
алғаусыз	adv
алғаш	adv
алғашқы	adj
алғашқыда	adv
алғашқыдай	
алғашқылық	noun
алғашқысында	adv
алғы	adj
алғы-бергі	
алғызу	verb
алғыншы	
алғыр	adj
алғырлық	noun
алғыс	noun
алғысөз	noun
алғыстау	verb
алғысты	adj
алғысхат	
алғытөлем	noun
алғытөлемді	
алғытөлемдік	
алғыш	noun
алғышарт	noun
алғыштау	
алда	prep
алда-жалда	adv
алдағы	adj
алдағыш	noun
алдамалау	
алдампаз	noun
алдампаздық	noun
алдамша	noun
алдамшы	adj
алдамшыланған	adj
алдамшылық	noun
алдамыш	adj
алдан	prep
алданған	adj
алданғызу	verb
алданғыш	adj
алдандырту	verb
алдандыру	verb
алдандырушы	
алданту	verb
алдану	verb
алданушы	
алданыс	noun
алданыш	noun
алданышсыз	
алдап	adj
алдап-арбау	verb
алдап-сулау	verb
алдарақ	
алдаркөсе	
Алдаркөсе	
алдаркөселік	
алдарқату	verb
алдаспан	noun
алдастыру	verb
алдасу	verb
алдату	verb
алдау	verb
алдау-арбау	
алдаусырату	verb
алдаушы	noun
алдаушылық	noun
алдауыш	noun
алдауыштық	
алдияр	adj
алдиярлау	verb
алды	prep
алды-алдына	
алды-арты	noun
алды-артына	
алдым-бердім	
алдымен	adv
алдын-ала	adv
алдыналушылық	noun
алдынан	adv
алдында	prep
алдыңгүні	adv
алдыңғы	adj
алдырмай-жұлдырмай	adv
алдырмай-шалдырмай	adv
алдырмайтындық	
алдырту	verb
алдыру	verb
алдырушы	noun
алебастр	
александрит	
алеут	
алжа-алжа	adj
алжапқыш	noun
алжапқыштық	
алжасқан	adj
алжастыру	verb
алжасу	verb
алжир	
алжу	verb
алжұмыр	noun
алжыту	verb
алиби	noun
алидада	
ализарин	
алимент	noun
алименттік	adj
алкалоид	
алкалоидтік	
алкоголизм	noun
алкоголь	noun
алкогольдендіру	verb
алкогольды	adj
алкогольсыз	adj
алкогольсіз	adj
алкүрең	
алқа	noun
алқа-қотан	
алқа-салқа	adj
алқаби	
алқабилік	
алқагүл	
алқалай	
алқалану	verb
алқалау	verb
алқалы	
алқалық	
алқам-салқам	adj
алқаның	
алқап	noun
алқаптану	
алқапты	adj
алқаптық	
алқау	verb
алқоры	noun
алқызыл	adj
алқызылдану	
алқылдау	verb
алқым	noun
алқым-жұлқым	
алқымдасу	verb
алқымдату	verb
алқымдау	verb
алқын	
алқын-жұлқын	
алқынды	noun
алқындыру	verb
алқынту	verb
алқыну	verb
алқыныс	noun
Алла	noun
аллалау	
Аллалау	verb
Аллатағала	noun
Аллауакбар	
аллашыл	
аллашылдық	noun
аллегория	noun
аллегориялық	adj
аллегро	
аллергия	noun
аллергиялы	adj
аллергиялық	adj
аллерголог	
аллея	noun
аллеялы	
аллигатор	noun
аллитерация	noun
аллитеризация	noun
алло	misc
аллограф	
аллопат	
аллопатия	noun
аллотропия	noun
аллотропиялық	adj
аллофон	
аллювий	
аллюр	
алма	noun
алма-кезек	adv
алма-қоспай	
алмаағаш	
алмағайып	adj
алмажегі	
алмаз	noun
алмазды	adj
алмақ	
алмаласу	verb
алмалау	verb
алмалы	adj
алмалы-салмалы	adj
алмас	noun
алмасатын	
алмасқызу	verb
алмасты	adj
алмастыратын	adj
алмастырғыш	
алмастырту	verb
алмастыру	verb
алмастырушы	noun
алмастырылатын	adj
алмастырылу	verb
алмасу	verb
алмасушы	
алмасушылық	noun
Алматы	
алмау	
алмауыт	adj
алмұрт	noun
алмұртшөп	
алмысақ	
алогизм	noun
алоэ	noun
алпамса	noun
алпамсадай	noun
алпар	
алпарысу	verb
алпауыт	adj
алпыс	card
алпыс-жетпіс	
алпысыншы	ord
алсын	noun
алтай	
алтайлық	noun
алтайы	adj
алтарь	noun
алтатар	
алтау	card
алтаулап	
алтаумыз	
алтаяқ	
алтаяқты	
алты	card
алты-жеті	
алтыатар	noun
алтыаяқ	noun
алтыбақан	
алтыбасар	
алтыбұрыш	
алтыжақты	
алтыкүндік	
алтылық	noun
алтын	noun
алтын-валюта	
алтын-күміс	
алтынағаш	
алтынбалық	
алтынгүл	
алтындаған	
алтындай	adj
алтындалған	
алтындалу	verb
алтындану	verb
алтындату	verb
алтындатылған	adj
алтындау	verb
алтындаушы	
алтынды	adj
алтынкөз	
алтынкүрек	
алтынқабақ	
алтынтамыр	
алтынтой	
алтыншар	
алтыншы	ord
алтыншыбық	
алтыншыдан	
алу	verb
алуа	noun
алуа-шекер	
алуан	adj
алуан-алуан	
алуан-түрлі	adj
алуан-шекер	
алуандас	adj
алужын	
алушы	noun
алфавит	noun
алфавитті	adj
алфавитті-жиілік	
алфавиттік	adj
алфавиттік-пәндік	
алхимик	noun
алхимия	noun
алхимиялық	adj
алхоры	noun
алша	noun
алшайту	verb
алшақ	adj
алшақталу	verb
алшақтану	verb
алшақтату	verb
алшақтау	verb
алшақтық	noun
алшалғыш	noun
алшаң	adj
алшаң-алшаң	adj
алшаңдату	verb
алшаңдау	verb
алшаөрік	noun
алшаю	verb
алшиту	verb
алшию	verb
алшы	
алшын	
алшындай	
алшынкөк	
алық	
алық-берік	
алық-салық	
алым	noun
алым-берім	
алым-жұлым	adj
алым-салық	verb
алым-салым	
алым-шығын	
алымды	adj
алымдылық	noun
алымқор	noun
алымқорлық	noun
алымпаз	noun
алымсақ	
алымсақ-берімсек	
алымсақтық	
алымсыз	adj
алымсыздық	noun
алымшы	
алымы	
алымыр	noun
алымыру	
алынбаған	adj
алынбау	
алынған	
алыну	verb
алып	noun
алып-ұшып	adv
алыпқаш	
алыпқашпа	
алыпқашты	noun
алыпсатар	noun
алыпсатарлық	noun
алыпсоқ	
алыптай	
алыптық	adj
алыпұшпа	
алыс	adj
алыс-беріс	noun
алыс-жақын	
алыс-жақындық	
алыс-жұлыс	noun
алыс-жырақ	adj
алыс-тартыс	
алысқа	adv
алыспақ	noun
алыссынбау	verb
алыссыну	verb
алыста	adv
алыстағы	adv
алыстан	adv
алыстату	verb
алыстатылу	verb
алыстау	verb
алыстық	noun
алыстыру	verb
алысу	verb
алысушы	
алысып-жұлысу	verb
алысырақ	
альбатрос	noun
альбинизм	noun
альбинос	noun
альбом	noun
альбумин	noun
альвеола	
альков	
альковты	
альманах	noun
альмандин	
альпентшток	
альпиниада	
альпинизм	noun
альпинист	noun
альпинистік	adj
альпілік	adj
альт	noun
альтерация	noun
альтернат	
альтернативтік	adj
альтернатор	
альтернация	noun
альтиметр	
альтруизм	noun
альтруист	
альтруистік	
альтшы	
альфа	noun
альфа-бөлшек	
альфа-бөлшектер	
альфа-сәулелер	
альянс	noun
алюминді	adj
алюминий	noun
алюминийлеу	
аляска	
ам	
амал	noun
Амал	
амал-айла	
амал-айламен	
амал-әрекет	noun
амалдау	verb
амалсыз	adj
амалсыздан	adv
амалсыздық	noun
амалшы	noun
амалшыл	adj
амалшылық	noun
амальгама	
амальгамалау	
аман	adj
аман-есен	adj
аман-есендік	noun
аман-сау	adj
аман-саулық	noun
аманат	noun
аманаттау	verb
аманаттық	
амандастыру	verb
амандасу	verb
амандау	verb
амандық	noun
амандық-саулық	noun
аманшылық	noun
амбар	noun
амбиция	noun
амбразура	noun
амбре	
амбулатория	noun
амбулаториялық	adj
амеба	noun
америка	adj
америкалық	noun
американ	noun
американдандырылған	adj
американдық	noun
аметист	
аметисті	
амиант	
амиантты	
амин	adj
аминқышқыл	
аммиак	noun
аммиакты	
аммоний	noun
амнезия	noun
амнистия	noun
амнистияланған	adj
амнистиялау	verb
аморальдық	
амортизатор	noun
амортизация	noun
амортизациялау	verb
амортизациялық	adj
аморф	
аморфты	adj
аморфтық	
ампер	
ампер-орам	
ампер-сағат	
амперметр	
ампир	
амплитуда	
амплитудалық	
амплуа	noun
ампула	noun
ампутация	noun
ампутациялау	verb
ампутациялық	adj
амур	noun
амфибия	noun
амфибрахий	
амфибрахийлік	
амфитеатр	
амфора	
ана	noun
ана-мына	
анабазис	
анабиоз	noun
анаграмма	noun
анағұрлым	adj
анада	adv
анадағы	adj
анадағыдай	
анадай	adjpron
анадайда	adv
анадан	adv
анажан	
анайы	adj
анайыланту	verb
анайылану	
анайылық	noun
анаконда	
анақұдай	noun
анал	
анализ	noun
анализатор	noun
анализдену	
анализдеу	verb
анализдік	
аналитика	noun
аналитикалық	adj
аналогия	noun
аналы-балалы	
аналық	noun
анальгин	
анаморфоз	
ананас	noun
анапест	
анар	noun
анаргүл	
анардай	adj
анартас	
анархизм	noun
анархист	
анархист-синдикалист	
анархистік	
анархия	noun
анархиялы	
анархиялық	adj
анархо-синдикализм	noun
анастомоз	
анасыз	
анатом	
анатомдау	verb
анатомдық	adj
анатомия	noun
анатомиялық	adj
анау	adjpron
анау-мынау	adj
анау-мынаусыз	
анафора	
анахронизм	noun
анахронизмдік	
анаш	noun
анаша	
анаэроб	
анаэробты	
ангажемент	
ангажементтеу	
ангар	noun
ангидрид	
ангина	noun
англицизм	noun
англо-американ	
англо-американдық	
англосакс	
анголалык	
анголар	
ангор	
ангстрем	
анда	adv
анда-мұнда	
анда-санда	adv
андағайлау	verb
андағы-мұндағы	
андаза	
андай-мұндай	
анданте	
андату	verb
андау	verb
андронов	
андыз	
андыз-андыз	
андызағаш	
андыздату	verb
андыздау	verb
аневризм	noun
аневризма	noun
анекдот	noun
анекдоттық	
анемограф	
анероид	
анестезиолог	
анестезиология	noun
анестезия	noun
анестезиялау	
анжы	noun
анжыма	
анжыр	
анжырлану	
анилин	noun
анимализм	noun
анималист	
анималистік	
анимация	noun
анимизм	noun
анион	
анис	
анкер	
анкет	noun
анкеталық	
анкеттік	
анналы	noun
аннексия	noun
аннексиялану	
аннексиялау	
аннексияшы	
аннотация	noun
аннотациялау	verb
аннотациялық	adj
аннуитеттік	
аннуляция	noun
анод	noun
анодтау	
анодты	
аноксия	noun
аномалия	noun
аноним	
анонс	
анонстау	
анорак	
анорганикалық	adj
ансамбль	noun
ансамбльдік	
ансар	
ант	noun
ант-су	
антагонизм	noun
антагонист	noun
антагонистік	adj
анталастыру	verb
анталасу	verb
анталату	verb
анталау	verb
антанта	
Антарктида	noun
Антарктика	noun
антарктикалық	adj
антатқан	
антбұзар	
антбұзушылық	noun
антенна	noun
антенналы	
антенналық	adj
антибиоз	
антибиотик	noun
антибөлшек	
антибөлшектер	
антивирустық	
антигендік	noun
антигигиеналық	
антигитлерлік	
антиғаламдастыру	
антиғаламдастырушы	
антидемократизм	noun
антидемократиялық	adj
антидене	
антидүние	noun
антидүниелік	
антизат	
антиимпериалистік	
антиинтеллектуализм	noun
антик	
антиквар	noun
антикварлық	adj
антикоммунизм	noun
антикоммунистік	adj
антимагниттік	
антимарксистік	
антиметатеза	
антимилитаризм	noun
антимилитаристік	
антимонархиялық	adj
антимоний	
антимонополия	noun
антимонополиялық	adj
антиномия	noun
антипартиялық	adj
антипатия	noun
антипатриоттық	
антипод	noun
антипозициялық	adj
антисанитариялық	adj
антисанитарлық	
антисемит	noun
антисемитизм	noun
антисемиттік	adj
антисептик	noun
антисептика	
антисептикалық	adj
антисептиктік	adj
антисоветтік	adj
антисоветші	noun
антитеза	
антитезис	
антитоксин	
антитоксиндік	
антифашизм	noun
антифашист	
антифашистік	
антифеодалдық	
антифриз	
антихрист	noun
антициклон	
антициклондық	
антқағаз	
антқор	
антқорлық	
антология	noun
антологиялық	adj
антоним	
антонимдік	
антоновка	
антпен	
антракт	noun
антрактілі	
антрацит	noun
антрекот	
антрепренер	
антресоль	noun
антропикалық	adj
антропогендік	noun
антропогенез	
антрополог	
антропология	noun
антропологиялық	adj
антропометр	
антропометрия	noun
антропометриялық	adj
антропоморфизм	noun
антропоним	
антропофаг	
антропоцентризм	noun
анттас	
анттасу	verb
антты	adj
антұрған	adj
анфилада	noun
анхазірет	
анхар	noun
анхуза	
анчар	
анчоус	
анша-мұнша	adv
аншлаг	
анығында	adv
анығырақ	
анық	adj
анық-қанық	
анық-танық	noun
анықтағыш	noun
анықталатын	adj
анықталатындық	
анықталған	adj
анықталғыш	
анықталмаған	adj
анықталмайтын	adj
анықталу	verb
анықтама	noun
анықтама-көрсеткіш	
анықтамалық	noun
анықтан-анық	adj
анықтану	verb
анықтап	
анықтасу	
анықтату	verb
анықтау	verb
анықтаушы	
анықтауыш	noun
анықтауыштық	
анықтық	noun
анықтылық	noun
анықырақ	
аң	noun
аң-таң	noun
аңғал	adj
аңғал-саңғал	adj
аңғалақ	adj
аңғалақтау	verb
аңғалақтық	
аңғалдану	verb
аңғалдық	noun
аңғалсақ	adj
аңғалсақтық	
аңғалсоқ	adj
аңғалсоқтық	
аңғар	noun
аңғар-аңғар	
аңғарғыш	adj
аңғарғыштық	noun
аңғарлау	verb
аңғарлы	adj
аңғарсыз	adj
аңғарту	verb
аңғару	verb
аңғарусыз	adv
аңғарылу	verb
аңғарым	noun
аңғарымды	adj
аңғарымдылық	noun
аңғарымпаз	adj
аңғарымпаздық	noun
аңғарысу	verb
аңғырт	adj
аңғыртсу	verb
аңғырттанбау	
аңғырттану	verb
аңғырттық	noun
аңғырттықтан	
аңғырту	verb
аңдағыш	adj
аңдағыштық	noun
аңдай	adv
аңдалу	
аңдамай	adv
аңдар	noun
аңдардың	adj
аңдарлық	
аңдасу	verb
аңдатпа	noun
аңдату	verb
аңдау	verb
аңдаусыз	adv
аңдаусызда	adv
аңдаусыздан	adv
аңдаусыздық	noun
аңдаушылық	noun
аңду	verb
аңдулы	
аңдусыз	
аңдушы	noun
аңдуыл	noun
аңдыған	adj
аңдығыш	
аңдысқан	
аңдыстыру	
аңдысу	verb
аңдыттыру	verb
аңдыту	verb
аңжалақ	
аңкалақтау	verb
аңку	verb
аңқ	
аңқа	noun
аңқайған	
аңқайту	verb
аңқалақтау	verb
аңқаңдау	verb
аңқау	adj
аңқау-аңғал	
аңқауланбау	
аңқаулану	verb
аңқаулау	adj
аңқаулық	noun
аңқаусу	verb
аңқаусыну	verb
аңқаю	verb
аңқиту	verb
аңқиып-саңқию	verb
аңқию	verb
аңқу	verb
аңқұмар	
аңқұмарлық	noun
аңқылдаған	
аңқылдақ	adj
аңқылдақтық	noun
аңқылдату	verb
аңқылдау	verb
аңқыту	verb
аңлау-саңлау	
аңсағай	
аңсағайлану	verb
аңсағайлау	
аңсаған	adj
аңсақ	
аңсар	noun
аңсату	verb
аңсау	verb
аңсаулы	adj
аңсаушылық	noun
аңсыз	adv
аңсызда	adv
аңсыздық	noun
аңсырату	verb
аңсырау	verb
аңтарылу	verb
аңтарылысу	
аңша	
аңшы	noun
аңшыл	
аңшылау	adj
аңшылық	noun
аңшылықтану	
аңыз	noun
аңызақ	
аңызғақ	
аңыздандыру	verb
аңыздаушы	
аңызды	adj
аңыздық	
аңызшы	
аңырайту	verb
аңырайып-саңыраю	verb
аңырайысу	verb
аңырақай	
аңыраңдау	
аңырасу	
аңырату	verb
аңырау	verb
аңыраю	verb
аңырту	verb
аңыру	verb
аңырысу	verb
аңыс	noun
аңысқойлық	
аңыстау	
аорист	
ап	misc
ап-айқын	adj
ап-аласа	
ап-алыс	
ап-анық	
ап-арзан	
ап-арық	adj
ап-ауыр	adj
ап-ашық	
ап-ащы	
апа	noun
апа-жезде	
апа-қарындас	
апа-сапа	
апағай	
апажан	noun
апай	noun
апай-топай	noun
апайтөс	
апақ-сапақ	
апақ-сапақта	
апалақ	
апалақ-сапалақ	adj
апалақтасу	verb
апалақтау	verb
апалаң-топалаң	noun
апалау	verb
апалы-сіңлілі	
апалық	noun
апан	noun
апандай	
апандық	
апаның	
апап-тапап	adv
апаратын	
апарғызу	verb
апартеид	
апартқызу	verb
апарту	verb
апару	verb
апарылу	verb
апарысу	verb
апас-қапас	noun
апас-қапаста	
апасының	adj
апат	noun
апатай	noun
апатайлату	verb
апатайлау	verb
апатит	
апатия	noun
апатиялық	adj
апатсыз	
апаттау	
апатты	adj
апаттық	adj
апаттылық	noun
апеке	noun
апекс	
апелляция	noun
апелляциялық	adj
апелляциясыз	adj
апельсин	noun
аперитив	
апикальды	
апитерапия	noun
апиын	noun
апиынның	
апиыншы	
апқы	
апогей	noun
аподиктілік	noun
апокалипсис	noun
апокрин	
апокринді	
апокриф	noun
апокрифтік	
аполитизм	noun
аполитик	adj
аполог	
апологет	
апологетика	
апологеттік	
апология	noun
апоплексия	noun
апорт	
апостериори	
апостериорлық	
апостиль	
апостильдеу	
апостол	noun
апостолдық	
апостроф	
апофема	
апофеоз	noun
апофония	noun
аппақ	adj
аппарат	noun
аппаратура	noun
аппаратхана	
аппаратшы	noun
аппассионато	
аппендикс	noun
аппендицит	noun
апперцепция	noun
аппликатура	
аппликация	noun
аппретура	
аппроксимация	noun
апраксия	noun
априори	
априорлық	adj
априорлылық	
апробация	noun
апробациялау	verb
апроши	
апсағай	adj
апсағайлану	verb
апсалдай	
апситу	verb
апсию	verb
апта	noun
аптағыш	
аптал	adj
апталап	
апталап-айлап	
апталау	
апталғыш	
апталу	
апталық	noun
апталым	
апталып-күптелу	verb
аптап	noun
аптапты	adj
аптату	verb
аптау	verb
аптығу	verb
аптығысу	verb
аптық	noun
аптыққан	
аптықпа	adj
аптықтыру	verb
апшу	verb
апшы	
апшыту	verb
апы	
апыл	
апыл-ғұпыл	adv
апыл-жұпыл	noun
апыл-құпыл	adv
апыл-тапыл	
апыл-тұпыл	
апыр-ай	prep
апыр-ау	
апыр-жапыр	noun
апыр-топыр	
апырайлау	
апырақтау	verb
апыраң-тапыраң	
апыраңдату	verb
апыраңдау	verb
апырау-ау	prep
апырым-ай	
апырым-ау	
апырып-жапыру	verb
ар	noun
ар-абырой	
ар-иман	
ар-инабат	
ар-намыс	noun
ар-намысты	adj
ар-ождан	noun
ар-ұждан	noun
ар-ұят	noun
ар-ұятсыз	adj
ар-ұятты	adj
ар-ұяттылық	noun
ара	noun
ара-арасы	
ара-арасында	prep
ара-тұра	adv
араб	noun
арабалық	
арабеск	
араби	
арабизм	noun
арабист	
арабтану	
арабша	
арабшалау	verb
арабшылау	verb
арабы	adj
арагонит	
арагідік	adv
арада	prep
арадағы	prep
аражегіш	
аражік	
араз	
араз-құраз	
араздасқызу	verb
араздастыру	verb
араздасу	verb
араздық	noun
арай	noun
арайландыру	verb
арайлану	verb
арайлату	verb
арайлау	verb
арайлы	adj
арайлылық	
арайсыз	adj
аракчеевшілдік	noun
арақ	noun
арақ-шарап	
арақатынас	noun
арақатынастылық	
арақатыс	noun
арақашықтық	noun
араққор	noun
араққорлық	noun
араққұмар	noun
араққұмарлық	noun
арақоспақ	
арал	noun
араланған	adj
аралану	
аралас	adj
аралас-құралас	adj
аралас-құраластық	
араласқан	noun
араласқызу	verb
араласпай	adv
араласпау	verb
араласпаушылық	noun
аралассыз	adj
араласты	
араластырғыш	
араластыру	verb
араластырылу	verb
араластырып	adv
араласу	verb
араласып	adv
аралатпа	adj
аралату	verb
аралау	verb
аралаушы	noun
аралды	adj
аралдық	adj
аралша	
аралшық	noun
аралы	adj
аралық	noun
арам	adj
арамдалу	verb
арамданбау	verb
арамдану	verb
арамдату	verb
арамдау	verb
арамдаушы	
арамдық	
арамей	
арамжуа	
арамза	adj
арамзада	adj
арамзалану	verb
арамзалы	
арамзалық	noun
арамқұлақ	noun
арамниеттілік	noun
арамойлылық	
арампиғылдық	
арамсирақ	
арамсояу	
арамсыну	verb
арамтаған	
арамтамақ	noun
арамтамақтар	
арамтамақтық	noun
арамтер	
арамтұмсық	
арамшағыр	
арамшөп	noun
арамшырмауық	
арамшытыр	
арамызда	prep
аран	noun
арандағыш	adj
арандай	
арандалу	verb
арандататын	
арандатқыш	
арандату	verb
арандатушы	noun
арандатушылық	noun
арандау	verb
аранжирлау	
аранжирлеуші	
аранжирлеушілік	noun
араншы	noun
араншылық	
арапшы	
арасалмақ	noun
арасан	
арасат	noun
арасында	prep
арасындағы	
арасынша	
арат	noun
араукария	noun
арахана	
араша	
арашаласу	verb
арашалату	verb
арашалау	verb
арашалаушы	
арашаруашылық	
арашашы	noun
арашы	noun
арашық	noun
арба	noun
арба-арба	
арба-сайман	
арбағаш	
арбағыш	noun
арбайтын	
арбакеш	noun
арбакештік	
арбақ-сарбақ	adj
арбалату	verb
арбалау	verb
арбалған	
арбалет	noun
арбалу	verb
арбалы	
арбалық	
арбандату	verb
арбаң	
арбаң-арбаң	
арбаң-құрбаң	
арбаң-тарбаң	adj
арбаң-тарбаңдық	
арбаң-ұрбаң	
арбаңдату	verb
арбаңдау	verb
арбасу	verb
арбату	verb
арбау	verb
арбаушы	noun
арбаушылық	noun
арбауыш	
арбаша	noun
арбашы	
арбашық	noun
арбиған	adj
арбитр	noun
арбитраж	adj
арбитраждық	adj
арбиту	verb
арбию	verb
арболит	
арбыз	noun
аргенталь	
аргентин	
арго	
аргон	
аргонавт	
арготизм	noun
аргумент	noun
аргументтеу	verb
арғас	
арғы	adj
арғы-бергі	
арғымақ	noun
арғымақтай	
арда	
ардагер	noun
ардағым	
ардақ	noun
ардақталу	verb
ардақтап	
ардақтату	verb
ардақтау	verb
ардақтаушы	
ардақты	adj
ардақтылық	noun
ардометр	
ардың-күрдің	adj
ареал	noun
ареалдық	
арена	noun
ареналық	
аренда	noun
арендалау	verb
арендалық	adj
арендатор	noun
ареология	noun
ареометр	
арестант	adj
арестанттық	adj
аржайы	adj
аржайыландыру	verb
аржайылану	verb
аржайылық	noun
аржақ	
аржақ-бержақ	
аржақтағы	
аржантин	
арзан	adj
арзандаған	
арзандату	verb
арзандатылған	adj
арзандатылу	verb
арзандау	verb
арзанды-қымбатты	
арзандық	noun
арзандылық	noun
арзанқол	
арзанқолды	
арзансу	verb
арзаншылық	noun
арзу	verb
ариетта	
арийлық	
арийлік	adj
ариозо	
аристократ	noun
аристократизм	noun
аристократия	noun
аристократтық	adj
аристофан	
аритмия	noun
аритмиялық	adj
арифметика	noun
арифметикалық	adj
арифмограф	
арифмометр	noun
ария	noun
арияйдай	
арка	noun
аркада	
арктика	adj
арктикалық	adj
арқа	noun
арқа-басы	
арқа-жарқа	
арқа-жеңі	
арқадағы	
арқал	
арқалайтын	adj
арқалану	verb
арқаласу	verb
арқалату	verb
арқалау	verb
арқалы	adj
арқалық	noun
арқамшы	
арқан	noun
арқан-жіп	
арқанаттау	
арқандалу	verb
арқандату	verb
арқандау	verb
арқандаулы	
арқансауыт	
арқантартпақ	
арқанша	
арқаншы	
арқар	
арқар-меринос	noun
арқарбұйырғын	
арқаржалақ	
арқаржапақ	
арқаржусан	
арқармүйіз	
арқасыз	
арқасыздық	noun
арқасында	prep
арқатұтушылық	noun
арқау	noun
арқау-желі	noun
арқау-өзек	
арқаулау	verb
арқаулы	adj
арқаулық	
арқаусыз	
арқаушыбық	
арқылы	prep
арқын-жарқын	adj
арқырасу	verb
арқырату	verb
арқырау	verb
арқырауық	
арлан	noun
арланбастан	adv
арланбау	
арланғыш	adj
арланғыштық	noun
арландай	
арландыру	verb
арлану	verb
арлау	verb
арлекин	noun
арлы	adj
арлылық	noun
арма	
армада	noun
арман	noun
арман-бермен	adj
арман-қиял	
арман-мақсат	
арман-тілек	
арманда	
армандас	
армандату	verb
армандау	verb
арманды	
армансыз	adj
армансыздық	noun
арманшыл	noun
арманшылдық	noun
армата	
арматура	noun
арматуралық	
арматурашы	
армия	noun
армиялық	adj
армрестлинг	
армян	noun
арна	noun
арнай	adj
арнайы	adj
арналас	
арналау	verb
арналған	
арналу	verb
арналы	
арналық	
арнап	adv
арнасу	verb
арнасыз	
арнату	verb
арнау	verb
арнаулы	adj
арнаухат	noun
арника	
арп	
арпа	noun
арпа-бидай	
арпабас	noun
арпабоз	
арпаған	
арпакөже	
арпалау	
арпалыс	noun
арпалысқызу	verb
арпалыстыру	verb
арпалысу	verb
арпаң-тарпаң	adj
арпасу	
арпаталқан	
арпашөп	
арпыл	
арпыл-тарпыл	adj
арпылдасу	verb
арпылдату	verb
арпылдау	verb
арс	
арс-арс	
арс-ұрс	
арса	
арса-арса	
арсақай	adj
арсалақтау	verb
арсалану	verb
арсалаң	
арсалаңдау	verb
арсаң	
арсаңдау	verb
арсенал	noun
арсиған	adj
арсию	verb
арсы-күрсі	adj
арсыз	adj
арсыздандыру	verb
арсыздану	verb
арсызданушылық	noun
арсызданып	adv
арсыздау	adj
арсыздық	noun
арсыл	noun
арсыл-күрсіл	
арсылдақ	noun
арсылдасу	verb
арсылдату	verb
арсылдау	verb
арсынбай	
арсыну	verb
арт	noun
артезиан	
артель	noun
артельдестіру	
артельдесу	verb
артельдік	adj
артельші	noun
артериола	
артериосклероз	
артерия	noun
артериялық	adj
артикль	
артикул	
артикуляция	noun
артикуляциялау	verb
артикуляциялық	adj
артиллерист	noun
артиллерия	noun
артиллериялық	adj
артиллерияшы	
артист	noun
артистік	adj
артистікпен	
артисше	
артқа	adv
артқан	adj
артқы	adj
артқызу	verb
артпа	adj
артпалы	
артрит	
артроз	
артта	prep
арттағы	adj
арттақалушылық	noun
арттан	prep
арттырмау	verb
арттыру	verb
арттырылған	adj
арттырылу	verb
арту	verb
арту-арту	adj
арту-тарту	verb
артушы	
арты	noun
артығы	
артығымен	
артық	adj
артық-ауыс	
артық-бұртық	
артық-кем	
артық-кемді	pron
артық-кемдік	
артықкетушілік	noun
артықсынбау	
артықсыну	verb
артықтау	
артықтық	noun
артықтылық	noun
артықша	adj
артықшылығы	noun
артықшылық	noun
артықшылықты	adj
артылған	adj
артылдыру	verb
артылу	verb
артылыс	
артымен	
артынан	adv
артында	prep
артыну	verb
артынша	prep
артынып-тартыну	verb
артып-тарту	verb
артысу	verb
ару	verb
аруақ	noun
аруақсыз	
аруақтай	
аруақтанбау	
аруақтану	verb
аруақтау	verb
аруақты	adj
аруақшыл	
аруана	
аруанадай	
аруз	
арулау	verb
арулық	noun
арфа	noun
арфашы	
архаизм	noun
архей	
археография	noun
археографиялық	adj
археолог	noun
археология	noun
археологиялық	adj
архив	adj
архивариус	
архивтік	adj
архившы	
архивші	
архиепископ	noun
архиерей	noun
архимандрит	
архипелаг	noun
архитектоника	
архитектор	noun
архитектура	noun
архитектуралық	adj
архифонема	
арша	noun
аршагүл	noun
аршадай	
аршалы	
аршалық	
аршашыл	
аршу	verb
аршулы	
аршушы	
аршығыш	
аршыл	
аршылған	adj
аршылмаған	adj
аршылу	verb
аршыма	
аршын	noun
аршынбар	
аршындай	
аршындату	verb
аршындау	verb
аршынды	adj
аршысу	verb
аршыту	verb
ары	adv
ары-бері	
арыған	
арыз	noun
арыздану	verb
арызданушы	noun
арыздастыру	verb
арыздасу	verb
арызкеш	
арызқағаз	
арызқой	
арызқойлық	
арызқор	
арызқұмар	
арызқұмарлық	noun
арызшы	noun
арызшыл	noun
арық	noun
арық-арна	
арық-атыз	
арық-жап	
арық-тұрақ	
арық-тұрық	
арықжалбыз	
арықсыну	verb
арықтату	verb
арықтау	verb
арықтұра	adj
арықтық	noun
арықша	adj
арыл	noun
арылдап-гүрілдеу	verb
арылдасып-шарылдасу	verb
арылдату	verb
арылдау	verb
арылдауық	
арылдыру	verb
арылмаған	adj
арылту	verb
арылу	verb
арымай-талмай	adv
арымайтын	adj
арын	noun
арындату	verb
арындау	verb
арындауық	adj
арынды	adj
арындылық	noun
арынсыз	adv
арыншыл	adj
арып-ашу	verb
арып-ашыған	
арып-талу	verb
арыпталу	verb
арыс	noun
Арыс	
арыстай	adj
арыстан	noun
Арыстан	
арыстандай	
арыстанқұйрық	noun
арыстанша	
арыту	verb
арыш	noun
арьергард	
арьергардтық	
ас	noun
ас-ауқат	
ас-дәм	
ас-су	noun
ас-тағам	noun
ас-шай	noun
аса	noun
асаба	noun
асабият	
асадал	noun
асай-мұса	noun
асай-мұсай	noun
асай-мүсей	
асаймұса	
асалы	
асам	
асанқайғы	adj
Асанқайғы	
асанқайғылану	
асанқайғылық	
асар	noun
асар-аспас	
асарлату	verb
асарлау	
асархана	
асаршы	
асатаяқ	noun
асатқызу	verb
асаттыру	verb
асату	verb
асау	verb
асау-албырт	adj
асаудай	
асаукөк	
асауланбау	
асаулану	verb
асаулық	noun
асаусу	verb
асаусыну	
асауыш	noun
асбасшы	
асбест	
асбестік	
асболит	
асбұзыл	
асбұршақ	noun
асейсмикалық	adj
асептика	
асептикалық	adj
асжаулық	noun
асимметрия	noun
асимметриялық	adj
асинергия	noun
асинхронды	
аскания	noun
асканиялық	adj
аскарида	
аскет	
аскетизм	noun
аскеттік	adj
аския	noun
аскорбин	
аскөк	noun
асқабақ	noun
асқабақтай	
асқазан	noun
асқақ	adj
асқақтаған	adj
асқақтану	verb
асқақтап	
асқақтату	verb
асқақтау	verb
асқақтаушылық	noun
асқақтық	noun
асқақтылық	noun
асқақшыл	
асқан	adj
асқандық	
асқар	adj
асқаралы	adj
асқардай	
асқасық	
асқатық	
асқатықтық	
асқорытқыш	
асқорыту	noun
асқызу	verb
асқын	prep
асқынған	adj
асқындату	verb
асқындау	verb
асқындырғыш	adj
асқындыру	verb
асқындырушы	noun
асқынөткізгіштік	noun
асқынту	verb
асқыну	verb
асқынушылық	noun
асқысыз	
асқыш	adj
асмалдық	
аспа	noun
аспа-жалап	adj
аспабесік	
аспаз	noun
аспаздық	noun
аспазхана	noun
аспазшы	noun
аспазшылық	
аспай-саспай	
аспакөпір	
аспалы	adj
аспан	noun
аспан-көк	
аспанға	adv
аспандағы	adj
аспандай	
аспандап	adv
аспандату	verb
аспандау	verb
аспанкез	
аспанкөк	
аспансерік	noun
аспап	noun
аспаптандыру	verb
аспаптану	
аспаптау	
аспапты	adj
аспаптық	adj
аспапшы	
аспара	
аспау	
аспашам	noun
аспект	noun
аспектолог	
аспектология	noun
аспид	
аспирант	noun
аспиранттық	
аспирантура	noun
аспиратор	
аспирация	noun
аспирин	noun
аспісірім	
ассалаумағалайкүм	
ассалаумаликум	
ассамблея	
ассемблер	
ассенизатор	noun
ассигнация	noun
ассигнациялау	verb
ассигновка	
ассиметрия	noun
ассимиляторлық	adj
ассимиляция	noun
ассимиляцияланған	adj
ассимиляциялану	verb
ассимиляциялау	verb
ассимиляциялық	adj
ассириялық	adj
ассистент	noun
ассистенттік	adj
ассонанс	
ассорти	
ассортимент	noun
ассоциативтік	adj
ассоциативтілік	
ассоциация	noun
ассоциациялану	verb
ассоциациялық	adj
ассүттіген	noun
аста-төк	adj
астағы	
астағыпыралла	
астазия	noun
астам	adj
астамдық	noun
астамсу	verb
астамсыту	verb
астамшыл	adj
астамшылық	noun
астан-кестен	noun
астана	noun
астаналы	
астаналық	adj
астапыралла	noun
астар	noun
астарқабат	
астарлану	verb
астарлап	
астарлас	
астарласу	verb
астарлату	verb
астарлау	verb
астарлы	adj
астарлық	
астарлылық	
астарсыз	
астас	noun
астастыру	verb
астасу	verb
астатым	noun
астау	noun
астаубас	
астаулау	
астауша	noun
астаушық	
астаһари	
астеник	
астения	noun
астерия	noun
астероид	noun
астигматизм	noun
астра	noun
астробиология	noun
астроботаника	
астрогеография	noun
астрогеология	noun
астрограф	
астролог	noun
астрология	noun
астролябия	noun
астронавт	noun
астронавтика	
астроном	noun
астрономия	noun
астрономиялық	adj
астрофизик	
астрофизика	
астрофизикалық	adj
астрофотография	noun
астрофотометр	
астрохимия	noun
асты	noun
асты-үсті	
асты-үстілі	
астық	noun
астықағаш	
астықжақсартқыш	
астықкептіргіш	
астықсыз	
астықтасығыш	
астықтиеуіш	
астықты	adj
астықхана	
астылы-үстілі	
астымен	
астын-үстін	
астына	adv
астынан	prep
астында	prep
астындағы	
астыңғы	adj
астырт	adv
астыртын	adv
астыру	verb
асу	verb
асу-асу	adj
асулы	adj
асулық	
асусыз	adj
асүй	noun
асүйлік	adj
асфальт	noun
асфальтобетон	
асфальтсыз	
асфальтталған	adj
асфальтталу	verb
асфальттану	verb
асфальттату	verb
асфальттау	verb
асфальтты	
асфальттық	
асфаһанды	
асфаһани	
асфиксия	noun
асхана	
асхана-фабрика	
асханалық	adj
асхананың	
асханашы	noun
асцит	noun
асшаян	noun
асшы	noun
асы	adj
асығу	verb
асығушы	
асығушылық	noun
асығымпаз	
асығып-аптығып	verb
асығып-үсігу	verb
асығып-үсігіп	adv
асығыс	adj
асығыс-үсігіс	
асығыста	adv
асығыстық	noun
асық	
асық-топай	
асықжілік	
асыққансу	verb
асыққыш	adj
асықпай	adv
асықпай-аптықпай	adv
асықпай-саспай	adv
асықпастан	
асықпау	verb
асықпаушылық	noun
асықтай	adj
асықты	
асықтырмау	
асықтыру	verb
асықша	
асыл	adj
асылатын	noun
асылған	adj
асылдандырғыш	adj
асылдандыру	verb
асылдану	verb
асылдық	noun
асылдыру	verb
асылзада	noun
асылма	noun
асылту	verb
асылтұқым	
асылтұқымды	
асылу	verb
асылы	noun
асылық	noun
асылында	
асылыну	verb
асым	
асынған	
асындыру	verb
асыну	verb
асып-сасу	verb
асып-сасушылық	noun
асып-сасып	adv
асып-тасу	verb
асып-тасушылық	noun
асыр	noun
асыр-насыр	noun
асыр-сауық	noun
асыр-тасыр	noun
асыр-тұсыр	noun
асыра	
асыралу	
асыралыну	verb
асыранды	adj
асырап-сақтаушы	noun
асырасу	verb
асырасілтеушілік	noun
асырату	verb
асырау	verb
асыраулы	
асыраусыз	
асыраушы	noun
асырғандық	noun
асырма	
асырмалы	
асыртпау	
асырту	verb
асыру	verb
асырылған	adj
асырылу	verb
асырым	
асысу	verb
ат	noun
ат-айғырлар	
ат-анжам	noun
ат-арба	noun
ат-атақ	
ат-жабдық	
ат-жарақ	
ат-көлік	noun
ат-күші	
ат-сайман	
ат-тон	
ат-топыр	
ат-тұрман	noun
ат-түйедей	
ат-шана	
ат-шапан	
ата	noun
ата-ана	
ата-анадай	
ата-аналар	
ата-аналық	
ата-баба	
ата-бабалар	
ата-бабалық	
ата-ене	
ата-енелік	
ата-мекен	noun
ата-мұра	
ата-тек	noun
атабек	
атавизм	noun
атавистік	
атағат	
атағаш	
атажау	
атажұрт	
атазаң	noun
атазу	
атай	noun
атайман	adj
атайы	adj
атакәсіп	
атакеш	
атаксия	noun
атақ	noun
атақ-абырой	
атақ-даңқ	noun
атақ-дәреже	
атаққұмар	adj
атаққұмарлық	noun
атақоныс	noun
атақсыз	adj
атақсыздық	noun
атақтану	verb
атақты	adj
атақтылық	noun
атақшыл	
атақшылық	noun
атал-сатал	adj
атала	
аталадай	
аталақтату	verb
аталақтау	verb
аталас	noun
аталастық	noun
аталатын	
аталау	verb
аталған	adj
аталғы	
аталмыш	
аталу	verb
аталы	adj
аталы-балалы	
аталық	adj
аталықсыздандыру	verb
аталым	noun
аталыну	verb
атамалы	
атаман	noun
атамандық	
атамекен	noun
атамзаман	adj
атамзаманда	
атамұра	noun
атан	
атанғызу	verb
атандай	
атандық	
атандыру	verb
атанжарыс	
атантұяқ	
атану	verb
атанша	
атаны	
атарман	noun
атарман-шабарман	noun
атастыру	verb
атастырылу	verb
атасу	verb
атасы	noun
ататегі	noun
ататек	
ататқызу	
ататтыру	verb
атату	verb
ататіл	
атау	verb
атау-кере	
атаукомитет	
атауланған	adj
атаулы	adj
атаулық	noun
атаунама	
атаусөз	noun
атаусыз	
атаушы	
атауыз	noun
атауыш	
аташ	
атәбзел	
атбағар	
атбайлар	
атбайлауыш	
атбалық	
атбас	
атбасбұршақ	noun
атбәйге	
атбегі	
атбегілік	
атбесік	
атбұршақ	
атдорба	noun
атеизм	noun
атеист	noun
атеистік	adj
атеке	noun
ателье	noun
атеросклероз	noun
атерін	
атерінді	
атжабу	
атжақты	
атжал	noun
атжалдану	verb
атжалдату	verb
атжалдау	verb
атжалман	noun
атжап	noun
атжарыс	
атжәмші	
атжетер	
атжуа	
атжүргіш	noun
атипия	noun
атком	noun
аткөпшік	
аткөпір	noun
аткөрпе	
атқағар	
атқазық	noun
атқамінер	noun
атқамінерлік	noun
атқарарлық	
атқарту	verb
атқару	verb
атқару-басқару	
атқарушы	noun
атқарушылық	adj
атқарылған	adj
атқарылу	verb
атқарым	
атқарысу	verb
атқонақ	
атқора	
атқосшы	noun
атқосшылы	
атқосшылық	
атқу	verb
атқұйрықтар	
атқұлақ	
атқұлақтану	verb
атқұмар	noun
атқұмарлық	noun
атқызу	verb
атқыласу	verb
атқылату	verb
атқылау	verb
атқыр	
атқыту	verb
атқыш	noun
атқыштар	adj
атқыштық	
атқышыл	
атлант	adj
атлас	noun
атлет	noun
атлетизм	noun
атлетика	noun
атлетикалық	adj
атлетші	noun
атмайы	
атмалтыс	
атмометр	
атмосфера	noun
атмосфералық	adj
атой	noun
атойласу	verb
атойлату	verb
атойлау	verb
атолл	
атом	noun
атом-молекулалық	
атомгер	
атомды	adj
атомдық	adj
атомизатор	
атомизм	noun
атомистика	noun
атомистік	
атомкеме	
атомсағат	
атомсыз	
атомшы	noun
атомшыл	
атомырауластыру	
атпа	
атпаз	
атпазығыр	
атпай-шаппай	
атпақияр	
атпақыл	
атпал	adj
атпалау	verb
атпалдай	
атпатамыр	
атпатамырлы	
атрезия	noun
атрибут	noun
атрибуттық	
атропин	noun
АТС	
атсайман	
атсайыс	
атсалысу	
атсалысушылық	noun
атсауыт	
атсейіс	
атсоқты	
атсыз	adj
атсыздану	verb
атсыншы	
атсілеусін	
аттай	adj
аттам	noun
аттамалы	adj
аттан	noun
аттандасу	verb
аттандату	verb
аттандау	verb
аттандыру	verb
аттандырушы	
аттану	verb
аттаныс	noun
аттанысу	verb
аттап	
аттарақ	
аттас	noun
аттастық	
аттасу	verb
аттатқызу	
аттату	verb
аттау	verb
атташе	noun
атташелік	
аттергеу	
аттерші	
аттеріс	noun
аттестат	noun
аттестаттау	verb
аттестатты	
аттестация	noun
аттестациялау	verb
аттестациялық	adj
аттракцион	noun
аттракциондық	
аттракция	noun
атты	adj
аттық	adj
аттылы	noun
аттылы-жаяу	
аттылы-жаяулы	
аттырма	
аттырма-оқ	noun
аттыру	verb
ату	verb
ату-стенд	
атұстар	
атүсті	adv
атүстілік	
атша	
атшабар	noun
атшабыс	
атшалман	
атшаптырым	
атшоңқай	
атшу	
атшы	noun
аты	noun
аты-жөні	noun
атығу	verb
атыз	noun
атыз-арық	
атыз-жап	
атыздай	
атыздалу	
атыздату	verb
атыздау	
атызды	
атылған	adj
атылу	verb
атылыс	noun
атым	noun
атымен	adv
атындағы	
атынды	noun
атыңқырау	
атырап	noun
атырау	noun
атыру	
атыс	noun
атыс-шабыс	noun
атыспақ	noun
атыстыру	verb
атысу	verb
атышулы	adj
ау	noun
ау-аулау	verb
ау-жылым	noun
ау-хау-хау	int
ауа	noun
ауадай	
ауажайылушылық	noun
ауаза	
ауаиіс	noun
ауаландыру	verb
ауалану	verb
ауалы	
ауам	adj
ауамдық	noun
ауан	noun
ауандау	verb
ауандық	noun
ауани	
ауаөткел	
ауаөткізгіш	noun
ауасуытқыш	
ауасүзгі	
ауасыз	adj
ауатазартқыш	
ауатамыр	
ауатком	noun
ауаүрлегіш	
аугер	noun
ауған	noun
ауғани	
Ауғанстан	noun
ауғаншылар	
ауғыздыру	
ауғызу	verb
ауғын	noun
ауғыш	adj
аудан	noun
ауданаралық	adj
аудандастыру	
аудандастырылу	
аудандау	verb
ауданды	
аудандық	adj
аударғыш	
аударма	noun
аудармай	adv
аудармалау	verb
аудармалы	
аудармалық	
аудармашы	noun
аудармашылық	
аударту	verb
аудару	verb
аударушы	noun
аударылған	adj
аударылмайтын	adj
аударылмалы	
аударылу	verb
аударылып-төңкерілу	verb
аударым	noun
аударып-төңкеру	verb
аударып-төңкерістіру	verb
аударыс	noun
аударыспақ	
аударыстыру	verb
аударысу	verb
аудиенция	noun
аудиокассета	
аудиомәлімдеме	
аудиометр	
аудиотаспа	
аудит	
аудитор	
аудитория	noun
аудиторлық	adj
аудыру	verb
аужай	noun
аужайлас	
аужайлау	verb
аужал	noun
аужар	adj
аужарлық	noun
аузы	noun
аузы-аузына	
аузы-басы	
аузы-мұрны	
аукцион	noun
аукциондық	
аукционер	
аукционшы	noun
ауқат	noun
ауқат-сауқат	
ауқатсыз	adj
ауқаттандыру	verb
ауқаттану	verb
ауқатты	adj
ауқаттылық	noun
ауқым	noun
ауқым-ауқым	adv
ауқымдану	verb
ауқымдасқызу	verb
ауқымдастыру	verb
ауқымдасу	verb
ауқымдау	verb
ауқымды	adj
ауқымдық	adj
ауқымдылық	noun
аула	noun
аулағыш	
аулақ	adv
аулақта	adv
аулақтанбау	
аулақтанған	adj
аулақтандыру	verb
аулақтандырылу	verb
аулақтану	verb
аулақтату	verb
аулақтатылу	
аулақтау	verb
аулалас	
аулалық	adj
аулану	verb
ауласу	verb
аулату	verb
аулау	verb
аулаушы	noun
аума	adj
аума-төкпе	adj
аумаған	adv
аумай	adv
аумайтын	adj
аумақ	noun
аумақсыз	adj
аумақтандыру	verb
аумақтану	verb
аумақтау	verb
аумақты	adj
аумақтық	adj
аумақтық-өндірістік	
аумақтық-шаруашылық	
аумалы	adj
аумалы-төкпелі	adj
аумалылық	noun
аумау	verb
аумашыл	
аумин	
аумыс	
аунақ	
аунақтау	
аунақшу	verb
аунақшып-дөңбекшу	verb
аунақшыту	verb
аунап-қунау	verb
аунату	verb
аунатылатын	adj
аунатылған	adj
аунатылу	
аунау	verb
аура	noun
ауру	noun
ауру-адам	
ауру-сауы	
ауру-сырқат	noun
ауру-сырқау	noun
ауру-сырқаулы	adj
ауру-сырқаулық	noun
ауру-індет	noun
ауруқоздырғыш	adj
ауруқоздырғыштар	
аурулау	adj
аурулы	adj
аурулы-сырқаулы	
аурулық	noun
аурусыз	adj
аурусыздық	noun
аурутуғызғыш	
аурухана	noun
ауруханалық	adj
ауруханаішілік	
аурушаң	
аурушаңдық	
аусар	adj
аусарлану	verb
аусарлық	noun
аустраль	
аусыл	
аут	noun
аутогенді	
аутодафе	
аутоқуыш	
аутсайд	
аутсайдер	noun
ауу	verb
аухал	noun
аухау	
аухаулау	verb
аушадияр	
аушы	noun
аушылық	noun
ауыз	noun
ауызашар	
ауызашарлық	
ауызаяқтылар	noun
ауызба-ауыз	
ауызбаққыш	
ауызбаққыштық	
ауызбастырық	
ауызбау	
ауызбен	adj
ауызби	
ауызбірлік	noun
ауызбірлікті	
ауызғы	adj
ауыздақтау	verb
ауыздан-ауызға	
ауызданбау	
ауыздандыру	verb
ауыздандырушы	
ауыздану	verb
ауызды	adj
ауыздық	noun
ауыздықсыз	adj
ауыздықталған	adj
ауыздықталу	verb
ауыздықтату	verb
ауыздықтау	verb
ауыздықтаулы	
ауыздықты	
ауызекі	adj
ауызжаппас	
ауызжолды	
ауызқобыз	
ауызомыртқа	noun
ауызот	
ауызсу	
ауызсулық	
ауызсырнай	noun
ауызтамыр	
ауызтатырлық	
ауызтұшырлық	
ауызүй	
ауызша	adj
ауық	adv
ауық-ауық	adv
ауыл	noun
ауыл-аймақ	
ауыл-ауыл	
ауыл-село	
ауыл-үй	noun
ауылағасы	
ауыларалық	adj
ауылбасы	
ауылдас	noun
ауылдастық	
ауылды	adj
ауылдық	adj
ауылжақтық	
ауылнай	
ауылнайлық	
ауылүй	
ауылша	
ауылшаруашылық	adj
ауылшарушылық	adj
ауылшылау	
ауылшылдық	noun
ауым-сауым	adj
ауын	
ауыңқы	
ауыр	adj
ауыр-ауыр	adj
ауыр-жеңіл	
ауырғыш	adj
ауырдәулетті	
ауырлаған	
ауырланбау	
ауырлану	verb
ауырлататын	
ауырлаттыру	verb
ауырлату	verb
ауырлау	verb
ауырлауы	
ауырлық	noun
ауырмағандай	
ауырмай-сырқамай	adv
ауырмалдық	
ауырмау	
ауырсындырмау	
ауырсыну	verb
ауырта	adv
ауыртатын	adj
ауыртаяқ	
ауыртқызбаушылық	noun
ауыртқыздырмау	
ауыртпай	adj
ауыртпайтын	
ауыртпақ	
ауыртпалық	noun
ауыртпалықсыз	adj
ауыртпалықты	noun
ауыртпау	noun
ауыртпаушылық	noun
ауырттырмау	
ауырту	verb
ауыру	verb
ауырыңқырау	verb
ауыс	
ауыс-түйіс	
ауысқан	
ауыспай	
ауыспайтын	adj
ауыспалы	adj
ауыспалылық	noun
ауыспас	adj
ауыспастан	
ауыспаушылық	noun
ауыстыратын	adj
ауыстырғыш	noun
ауыстырмалы	adj
ауыстырту	verb
ауыстыру	verb
ауыстырушы	noun
ауыстырушылық	noun
ауыстырылатын	adj
ауыстырылған	adj
ауыстырылу	verb
ауыстырылымдылық	noun
ауыстырып-қосқыш	noun
ауысу	verb
ауысым	noun
ауысымалды	
ауысымды	
ауысымдық	
ауысымдылық	noun
ауысып	adv
ауыт	noun
ауытқу	verb
ауытқулық	noun
ауытқушы	
ауытқушылық	noun
ауытқығыш	adj
ауытқыма	noun
ауытқымайтын	adj
ауытқымалы	adj
ауытқымалық	
ауытқымаушылық	noun
ауытқыту	verb
ауытқыш	
ауыттау	verb
ауыттыру	verb
афазия	noun
афиша	noun
афониялық	adj
афоризм	noun
афоризмдік	
африка	adj
африкалық	adj
африкандық	noun
афронт	
аффект	noun
аффективтік	adj
аффектілеу	
афференттік	adj
аффикс	
аффикстегі	
аффинаж	noun
аффинаждау	
аффрикат	
ах	misc
аха-ха	
аха-халау	verb
аха-хау	
аха-хаулау	verb
АХАЖ	noun
АХАТ	noun
ахау	
ахком	
ахлақ	
ахлақсыздық	noun
ахромат	
ахроматизм	noun
ахроматикалық	adj
ахроматопсия	noun
ахуал	noun
ахуалат	
ахун	
аһ	misc
аһлау	verb
аһылап-уһілеу	
аһылап-үһілеу	verb
аһылау	
ацетилен	
ацетон	noun
ацетонды	
ацидоз	
ацидофил	
ацидофилді	
ацидофилин	
ацтек	
ацтектер	
аш	adj
аш-арық	
аш-жалаңаш	adj
аш-жалаңаштық	noun
аш-тоқ	
аша	noun
ашабүйір	
ашаланбау	
ашалану	verb
ашалаң	
ашалау	verb
ашалы	
ашалық	
ашамай	
ашамайлану	
ашамайлату	verb
ашамайлау	verb
ашамайлы	
ашамайлық	
ашамұрт	
ашамүйізділер	
ашаң	adj
ашаңданбау	
ашаңдану	verb
ашаңдау	adj
ашаңдық	noun
ашар	noun
ашаршылық	noun
ашарық	
ашатұяқ	
ашатұяқты	
ашатұяқтылар	noun
ашауыз	noun
ашбаспақ	
ашбүйір	
ашкөз	adj
ашкөздену	verb
ашкөздік	
ашкөзділік	
ашкүзендей	
ашқарақ	adj
ашқарақтану	verb
ашқарақтық	noun
ашқарын	
ашқарынға	
ашқарында	
ашқызу	verb
ашқыл	
ашқылтым	adj
ашқылтымдану	verb
ашқылтымдық	
ашқыш	noun
ашналықпен	adv
ашпа	
ашпа-жалап	
ашпалы	
ашпалы-жаппалы	
ашпасәліп	
аштатын	
ашты	adj
ашты-тоқты	
аштық	noun
аштырту	verb
аштыру	verb
ашу	verb
ашу-араз	
ашу-араздық	
ашу-аяң	
ашу-реніш	
ашу-ыза	
ашуат	noun
ашуатшөп	
ашуг	
ашудас	
ашудастау	
ашукернеген	
ашуқор	adj
ашуланбайтын	
ашуланған	adj
ашуланғандық	noun
ашуланғызу	verb
ашуланғыш	adj
ашуландыру	verb
ашулану	verb
ашуланшақ	adj
ашуланшақтық	noun
ашуланысу	verb
ашулы	adj
ашулылық	noun
ашумен	adv
ашусыз	adj
ашушаң	adj
ашушаңдық	noun
ашушы	
ашыған	adj
ашығу	verb
ашығыш	
ашық	adj
ашық-жарқын	adj
ашық-жарық	adj
ашық-тесік	
ашық-шашық	adv
ашықауыз	noun
ашықауыздану	verb
ашықауыздық	
ашыққан	noun
ашықтан-ашық	adj
ашықтық	noun
ашықтырту	verb
ашықтыру	verb
ашықхат	
ашылауыт	
ашылған	adj
ашылмаған	adj
ашылмалы	
ашылмалы-жабылмалы	adj
ашылу	verb
ашылулар	
ашылым	noun
ашылыңқыраған	
ашылыңқырау	verb
ашылып-жабылу	verb
ашылып-шашылу	verb
ашылыс	noun
ашымақ	noun
ашымал	
ашына	noun
ашына-жай	noun
ашына-жайлық	noun
ашыналасу	
ашыналық	noun
ашынған	
ашындыру	verb
ашынту	verb
ашыну	verb
ашынушылық	noun
ашыңқы	
ашыңқырау	verb
ашып-жабу	verb
ашып-жарып	adv
ашып-жұмғанша	adv
ашып-жұму	
ашып-шашу	verb
ашыр	
ашырқандыру	verb
ашырқанту	verb
ашырқану	verb
ашырлық	
ашысу	verb
ашытатын	
ашытқан	
ашытқы	noun
ашытқылану	
ашытқылау	verb
ашытқылық	
ашытқыш	
ашытпа	
ашыту	verb
ашытылған	adj
ашытылмаған	adj
ашытылу	verb
ашішек	
ащы	adj
ащы-тұщы	
ащыландыру	verb
ащылату	verb
ащылау	verb
ащылауыт	
ащылы-тұщылы	
ащылық	noun
ащыот	
ащысыну	verb
ащытамыр	
аэрарии	
аэроәдіс	
аэроб	
аэробика	
аэробты	
аэробтық	
аэробус	
аэроген	
аэрогенді	
аэрогеология	noun
аэрогеологиялық	adj
аэрограф	
аэрография	noun
аэроғарыш	
аэроғарыштық	
аэродинамика	
аэродинамикалық	adj
аэродром	noun
аэрозоль	noun
аэрозольдық	
аэроклуб	
аэроқұрылыс	
аэролит	
аэролифт	
аэролог	
аэрология	noun
аэрологиялық	adj
аэромагнит	
аэромагниттік	
аэромектеп	
аэрометр	
аэрометрия	noun
аэрометриялық	adj
аэромеханика	
аэромобиль	
аэромотор	
аэрон	
аэронавигация	noun
аэронавигациялық	adj
аэронавт	
аэронавтика	
аэроплан	noun
аэропланшет	
аэропочта	
аэропошта	
аэросебу	
аэростат	
аэростатика	
аэросурет	
аэросүзгі	
аэротаксация	noun
аэротермометр	
аэротозаңдандырғыш	adj
аэрофлот	noun
аэрофон	
аэрофотометрия	noun
аэрофотосурет	
аэрофототүсіру	
аэрошамшырақ	
аэрошана	
аю	noun
аюбадам	
аюбалдырған	
аюдай	adj
аюдам	noun
аюдың	adj
аюжаңғақ	
аюжидек	
аюжүн	
аюқурай	
аюқұлақ	
аюоты	noun
аютабан	
ая	noun
аябоз	
Аягөз	
аяғында	adv
аяғыш	adj
аяғыштық	noun
аядай	adj
аяз	noun
Аязата	
аяздай	
аяздату	verb
аяздау	verb
аязды	adj
аяздық	adj
аяқ	noun
аяқ-басы	noun
аяқ-қол	noun
аяқ-қолы	
аяқ-табақ	noun
аяқарба	
аяқасты	
аяқастынан	adv
аяқбас	
аяқбау	noun
аяқбәйге	
аяқдоп	noun
аяқдопшы	noun
аяқжақсы	
аяқжол	noun
аяқкиім	noun
аяққабу	
аяққап	
аяққаптай	adj
аяққұйрықтылар	noun
аяққұр	
аяққы	
аяқмәшине	
аяқсу	verb
аяқсыз	adj
аяқсыту	verb
аяқтабақ	
аяқталған	adj
аяқталды	
аяқталмаған	adj
аяқталмайтын	adj
аяқталу	verb
аяқтама	noun
аяқтамау	verb
аяқтандыру	verb
аяқтану	verb
аяқтасу	verb
аяқтату	verb
аяқтау	verb
аяқтоғыз	
аяқты	
аяқша	
аяқшы	
аял	noun
аялану	
аялату	verb
аялау	verb
аялдама	noun
аялдама-бекініс	
аялдасу	verb
аялдату	verb
аялдау	verb
аялы	adj
аямай	adv
аямастан	adv
аямпаз	adj
аямпаздау	verb
аян	adj
аянбай	adv
аянбау	
аянкес	
аянкестік	
аяну	verb
аяншақ	adj
аяншақтанбау	
аяншақтану	verb
аяншақтау	verb
аяншақтық	noun
аяныш	noun
аянышты	adj
аяныштылық	noun
аяныштырақ	
аяң	
аяң-жортақ	
аяң-жортаң	
аяңдап	
аяңдасу	
аяңдату	verb
аяңдау	verb
аяңшыл	
аяр	adj
аярлану	verb
аярлығы	
аярлық	noun
аярсу	verb
аясыз	
аят	
аят-хадис	noun
аятолла	
аятулкүрсі	
аяу	verb
аяулы	adj
аяусыз	adj
аяусыздық	noun
аяушылық	noun
аяш	noun

